//MAP CONVERTED BY dmm2tgm.py THIS HEADER COMMENT PREVENTS RECONVERSION, DO NOT REMOVE
"a" = (
/turf/closed/mineral/titanium,
/area/ruin/space/has_grav/powered)
"b" = (
/turf/closed/mineral/uranium,
/area/ruin/space/has_grav/powered)
"c" = (
/turf/open/floor/plating/asteroid/basalt/lava_land_surface,
/area/ruin/space/has_grav/powered)
"d" = (
/turf/open/floor/circuit/green/airless,
/area/ruin/space/has_grav/powered)
"e" = (
/turf/open/floor/mech_bay_recharge_floor,
/area/ruin/space/has_grav/powered)

(1,1,1) = {"
a
a
a
a
a
a
a
a
a
a
a
a
a
a
a
a
a
a
a
a
a
a
a
"}
(2,1,1) = {"
a
b
b
b
c
c
c
c
c
c
c
c
c
c
c
c
c
c
c
b
b
b
a
"}
(3,1,1) = {"
a
b
b
c
c
c
c
c
c
c
c
c
c
c
c
c
c
c
c
c
b
b
a
"}
(4,1,1) = {"
a
b
c
c
c
c
c
c
c
c
c
c
c
c
c
c
c
c
c
c
c
b
a
"}
(5,1,1) = {"
a
c
c
c
c
c
c
c
c
c
c
c
c
c
c
c
c
c
c
c
c
c
a
"}
(6,1,1) = {"
a
c
c
c
c
c
c
c
c
c
c
c
c
c
c
c
c
c
c
c
c
c
a
"}
(7,1,1) = {"
a
c
c
c
c
c
c
c
c
c
c
c
c
c
c
c
c
c
c
c
c
c
a
"}
(8,1,1) = {"
a
c
c
c
c
c
c
c
c
c
c
c
c
c
c
c
c
c
c
c
c
c
a
"}
(9,1,1) = {"
a
c
c
c
c
c
c
c
c
c
c
c
c
c
c
c
c
c
c
c
c
c
a
"}
(10,1,1) = {"
a
c
c
c
c
c
c
c
c
c
d
d
d
d
c
c
c
c
c
c
c
c
a
"}
(11,1,1) = {"
a
c
c
c
c
c
c
c
c
c
d
e
e
d
c
c
c
c
c
c
c
c
a
"}
(12,1,1) = {"
a
c
c
c
c
c
c
c
c
c
d
e
e
d
c
c
c
c
c
c
c
c
a
"}
(13,1,1) = {"
a
c
c
c
c
c
c
c
c
c
d
d
d
d
c
c
c
c
c
c
c
c
a
"}
(14,1,1) = {"
a
c
c
c
c
c
c
c
c
c
c
c
c
c
c
c
c
c
c
c
c
c
a
"}
(15,1,1) = {"
a
c
c
c
c
c
c
c
c
c
c
c
c
c
c
c
c
c
c
c
c
c
a
"}
(16,1,1) = {"
a
c
c
c
c
c
c
c
c
c
c
c
c
c
c
c
c
c
c
c
c
c
a
"}
(17,1,1) = {"
a
c
c
c
c
c
c
c
c
c
c
c
c
c
c
c
c
c
c
c
c
c
a
"}
(18,1,1) = {"
a
c
c
c
c
c
c
c
c
c
c
c
c
c
c
c
c
c
c
c
c
c
a
"}
(19,1,1) = {"
a
c
c
c
c
c
c
c
c
c
c
c
c
c
c
c
c
c
c
c
c
c
a
"}
(20,1,1) = {"
a
b
c
c
c
c
c
c
c
c
c
c
c
c
c
c
c
c
c
c
c
b
a
"}
(21,1,1) = {"
a
b
b
c
c
c
c
c
c
c
c
c
c
c
c
c
c
c
c
c
b
b
a
"}
(22,1,1) = {"
a
b
b
a
c
c
c
c
c
c
c
c
c
c
c
c
c
c
c
b
b
b
a
"}
(23,1,1) = {"
a
a
a
a
a
a
a
a
a
a
a
a
a
a
a
a
a
a
a
a
a
a
a
"}
