//MAP CONVERTED BY dmm2tgm.py THIS HEADER COMMENT PREVENTS RECONVERSION, DO NOT REMOVE
"a" = (
/turf/closed/mineral/random/minecraft,
/area/lavaland/surface/outdoors/explored)
"b" = (
/turf/open/floor/minecraft,
/area/lavaland/surface/outdoors/explored)
"c" = (
/mob/living/simple_animal/hostile/asteroid/goliath/zombie,
/turf/open/floor/minecraft,
/area/lavaland/surface/outdoors/explored)
"d" = (
/turf/closed/wall/minecraft/cobblestone,
/area/lavaland/surface/outdoors/explored)
"e" = (
/obj/item/claymore/minecraft,
/obj/item/pickaxe/minecraft,
/turf/open/floor/minecraft/stone,
/area/lavaland/surface/outdoors/explored)
"f" = (
/mob/living/simple_animal/hostile/asteroid/hivelord/creeper,
/turf/open/floor/minecraft,
/area/lavaland/surface/outdoors/explored)
"g" = (
/mob/living/simple_animal/hostile/asteroid/basilisk/ghast,
/turf/open/floor/minecraft,
/area/lavaland/surface/outdoors/explored)
"h" = (
/obj/structure/mineral_door/wood,
/turf/open/floor/minecraft/stone,
/area/lavaland/surface/outdoors/explored)
"i" = (
/obj/item/minecraft/cobblestone,
/turf/open/floor/minecraft/stone,
/area/lavaland/surface/outdoors/explored)
"T" = (
/turf/closed/mineral/random/minecraft,
/area/lavaland/surface/outdoors/unexplored/danger)

(1,1,1) = {"
a
T
T
T
T
T
T
T
T
T
T
T
T
T
T
T
T
T
T
T
T
T
T
T
T
"}
(2,1,1) = {"
a
T
T
T
T
T
T
T
T
T
T
T
T
T
T
T
T
T
T
T
T
T
T
T
T
"}
(3,1,1) = {"
a
T
T
T
T
T
T
T
T
T
T
T
T
T
T
T
T
T
T
T
T
T
T
T
T
"}
(4,1,1) = {"
a
T
T
T
T
a
a
a
a
a
a
a
a
a
a
a
T
T
T
T
T
T
T
T
T
"}
(5,1,1) = {"
a
T
T
T
a
a
b
b
b
b
c
b
b
b
b
a
a
T
T
T
T
T
T
T
T
"}
(6,1,1) = {"
a
T
T
T
a
b
b
b
b
b
b
b
b
b
b
b
a
T
T
T
T
T
T
T
T
"}
(7,1,1) = {"
a
T
T
T
a
b
b
d
d
d
d
d
d
d
b
g
a
T
T
T
T
T
T
T
T
"}
(8,1,1) = {"
a
T
T
T
a
b
b
d
e
i
i
i
i
d
b
b
a
T
T
T
T
T
T
T
T
"}
(9,1,1) = {"
a
T
T
T
a
b
b
d
i
i
i
i
i
d
b
b
a
T
T
T
T
T
T
T
T
"}
(10,1,1) = {"
a
T
T
T
a
c
b
d
i
i
i
i
i
d
b
b
a
T
T
T
T
T
T
T
T
"}
(11,1,1) = {"
a
T
T
T
a
b
b
d
i
i
i
i
i
h
b
b
a
T
T
T
T
T
T
T
T
"}
(12,1,1) = {"
a
T
T
T
a
b
b
d
i
i
i
i
i
h
b
b
a
T
T
T
T
T
T
T
T
"}
(13,1,1) = {"
a
T
T
T
a
b
b
d
i
i
i
i
i
d
b
b
a
T
T
T
T
T
T
T
T
"}
(14,1,1) = {"
a
T
T
T
a
b
b
d
i
i
i
i
i
d
b
b
a
T
T
T
T
T
T
T
T
"}
(15,1,1) = {"
a
T
T
T
a
b
b
d
i
i
i
i
i
d
b
b
a
T
T
T
T
T
T
T
T
"}
(16,1,1) = {"
a
T
T
T
a
b
b
d
i
i
i
i
i
d
b
b
a
T
T
T
T
T
T
T
T
"}
(17,1,1) = {"
a
T
T
T
a
b
b
d
d
d
d
d
d
d
b
b
a
T
T
T
T
T
T
T
T
"}
(18,1,1) = {"
a
T
T
T
a
a
b
b
b
b
b
b
b
b
b
a
a
T
T
T
T
T
T
T
T
"}
(19,1,1) = {"
a
T
T
T
T
a
b
b
b
b
b
b
b
b
b
a
T
T
T
T
T
T
T
T
T
"}
(20,1,1) = {"
a
T
T
T
T
a
a
a
a
b
b
f
a
a
a
a
T
T
T
T
T
T
T
T
T
"}
(21,1,1) = {"
a
T
T
T
T
T
T
T
a
b
b
b
a
T
T
T
T
T
T
T
T
T
T
T
T
"}
(22,1,1) = {"
a
T
T
T
T
T
T
T
a
b
b
g
a
T
T
T
T
T
T
T
T
T
T
T
T
"}
(23,1,1) = {"
a
T
T
T
T
T
T
T
a
b
c
b
a
T
T
T
T
T
T
T
T
T
T
T
T
"}
(24,1,1) = {"
a
T
T
T
T
T
T
T
a
b
b
b
a
T
T
T
T
T
T
T
T
T
T
T
T
"}
(25,1,1) = {"
a
T
T
T
T
T
T
T
a
b
b
b
a
T
T
T
T
T
T
T
T
T
T
T
T
"}
