//MAP CONVERTED BY dmm2tgm.py THIS HEADER COMMENT PREVENTS RECONVERSION, DO NOT REMOVE
"a" = (
/turf/closed/mineral/random/minecraft,
/area/space)
"b" = (
/turf/open/floor/minecraft,
/area/space)
"c" = (
/mob/living/simple_animal/hostile/asteroid/goliath/zombie,
/turf/open/floor/minecraft,
/area/space)
"d" = (
/turf/closed/wall/minecraft/cobblestone,
/area/space)
"e" = (
/obj/item/claymore/minecraft,
/obj/item/pickaxe/minecraft,
/turf/open/floor/minecraft/stone,
/area/space)
"f" = (
/mob/living/simple_animal/hostile/asteroid/hivelord/creeper,
/turf/open/floor/minecraft,
/area/space)
"g" = (
/mob/living/simple_animal/hostile/asteroid/basilisk/ghast,
/turf/open/floor/minecraft,
/area/space)
"h" = (
/obj/structure/mineral_door/wood,
/turf/open/floor/minecraft/stone,
/area/space)
"i" = (
/obj/item/minecraft/cobblestone,
/turf/open/floor/minecraft/stone,
/area/space)

(1,1,1) = {"
a
a
a
a
a
a
a
a
a
a
a
a
a
a
a
a
a
a
a
a
a
a
a
a
a
"}
(2,1,1) = {"
a
a
a
a
a
a
a
a
a
a
a
a
a
a
a
a
a
a
a
a
a
a
a
a
a
"}
(3,1,1) = {"
a
a
a
a
a
a
a
a
a
a
a
a
a
a
a
a
a
a
a
a
a
a
a
a
a
"}
(4,1,1) = {"
a
a
a
a
a
a
a
a
a
a
a
a
a
a
a
a
a
a
a
a
a
a
a
a
a
"}
(5,1,1) = {"
a
a
a
a
a
a
b
b
b
b
c
b
b
b
b
a
a
a
a
a
a
a
a
a
a
"}
(6,1,1) = {"
a
a
a
a
a
b
b
b
b
b
b
b
b
b
b
b
a
a
a
a
a
a
a
a
a
"}
(7,1,1) = {"
a
a
a
a
a
b
b
d
d
d
d
d
d
d
b
g
a
a
a
a
a
a
a
a
a
"}
(8,1,1) = {"
a
a
a
a
a
b
b
d
e
i
i
i
i
d
b
b
a
a
a
a
a
a
a
a
a
"}
(9,1,1) = {"
a
a
a
a
a
b
b
d
i
i
i
i
i
d
b
b
a
a
a
a
a
a
a
a
a
"}
(10,1,1) = {"
a
a
a
a
a
c
b
d
i
i
i
i
i
d
b
b
a
a
a
a
a
a
a
a
a
"}
(11,1,1) = {"
a
a
a
a
a
b
b
d
i
i
i
i
i
h
b
b
a
a
a
a
a
a
a
a
a
"}
(12,1,1) = {"
a
a
a
a
a
b
b
d
i
i
i
i
i
h
b
b
a
a
a
a
a
a
a
a
a
"}
(13,1,1) = {"
a
a
a
a
a
b
b
d
i
i
i
i
i
d
b
b
a
a
a
a
a
a
a
a
a
"}
(14,1,1) = {"
a
a
a
a
a
b
b
d
i
i
i
i
i
d
b
b
a
a
a
a
a
a
a
a
a
"}
(15,1,1) = {"
a
a
a
a
a
b
b
d
i
i
i
i
i
d
b
b
a
a
a
a
a
a
a
a
a
"}
(16,1,1) = {"
a
a
a
a
a
b
b
d
i
i
i
i
i
d
b
b
a
a
a
a
a
a
a
a
a
"}
(17,1,1) = {"
a
a
a
a
a
b
b
d
d
d
d
d
d
d
b
b
a
a
a
a
a
a
a
a
a
"}
(18,1,1) = {"
a
a
a
a
a
a
b
b
b
b
b
b
b
b
b
a
a
a
a
a
a
a
a
a
a
"}
(19,1,1) = {"
a
a
a
a
a
a
b
b
b
b
b
b
b
b
b
a
a
a
a
a
a
a
a
a
a
"}
(20,1,1) = {"
a
a
a
a
a
a
a
a
a
b
b
f
a
a
a
a
a
a
a
a
a
a
a
a
a
"}
(21,1,1) = {"
a
a
a
a
a
a
a
a
a
b
b
b
a
a
a
a
a
a
a
a
a
a
a
a
a
"}
(22,1,1) = {"
a
a
a
a
a
a
a
a
a
b
b
g
a
a
a
a
a
a
a
a
a
a
a
a
a
"}
(23,1,1) = {"
a
a
a
a
a
a
a
a
a
b
c
b
a
a
a
a
a
a
a
a
a
a
a
a
a
"}
(24,1,1) = {"
a
a
a
a
a
a
a
a
a
b
b
b
a
a
a
a
a
a
a
a
a
a
a
a
a
"}
(25,1,1) = {"
a
a
a
a
a
a
a
a
a
b
b
b
a
a
a
a
a
a
a
a
a
a
a
a
a
"}
