//MAP CONVERTED BY dmm2tgm.py THIS HEADER COMMENT PREVENTS RECONVERSION, DO NOT REMOVE
"a" = (
/turf/template_noop,
/area/ruin/powered/e1m1)
"b" = (
/turf/closed/wall/mineral/plastitanium/doomed,
/area/ruin/powered/e1m1)
"c" = (
/obj/effect/mob_spawn/human/corpse/nanotrasenassaultsoldier,
/turf/open/floor/carpet/black,
/area/ruin/powered/e1m1)
"d" = (
/turf/open/floor/carpet/black,
/area/ruin/powered/e1m1)
"e" = (
/obj/structure/rack,
/obj/item/twohanded/required/chainsaw,
/turf/open/floor/carpet/black,
/area/ruin/powered/e1m1)
"f" = (
/obj/structure/rack,
/obj/item/gun/ballistic/shotgun/doomed,
/turf/open/floor/carpet/black,
/area/ruin/powered/e1m1)
"g" = (
/turf/open/floor/plasteel/dark,
/area/ruin/powered/e1m1)
"h" = (
/obj/machinery/door/airlock/titanium/doomed,
/turf/open/floor/plasteel/dark,
/area/ruin/powered/e1m1)
"i" = (
/turf/open/floor/plating/asteroid,
/area/ruin/powered/e1m1)
"j" = (
/obj/structure/fermenting_barrel/doom,
/turf/open/floor/plasteel/dark,
/area/ruin/powered/e1m1)
"k" = (
/obj/item/reagent_containers/glass/beaker/synthflesh/healthvial,
/turf/open/floor/plasteel/dark,
/area/ruin/powered/e1m1)
"l" = (
/turf/closed/wall/mineral/titanium/survival/pod,
/area/ruin/powered/e1m1)
"m" = (
/obj/item/stack/sheet/animalhide/goliath_hide/vest,
/obj/item/stack/sheet/animalhide/goliath_hide/vest,
/obj/item/stack/sheet/animalhide/goliath_hide/vest,
/turf/open/floor/plasteel/dark,
/area/ruin/powered/e1m1)
"n" = (
/obj/machinery/light{
	dir = 8
	},
/turf/open/floor/plasteel/dark,
/area/ruin/powered/e1m1)
"o" = (
/obj/effect/spawner/structure/window/plastitanium,
/turf/open/floor/plasteel/dark,
/area/ruin/powered/e1m1)
"p" = (
/obj/structure/rack,
/obj/item/stack/sheet/animalhide/goliath_hide/vest/blue,
/obj/item/stack/sheet/animalhide/goliath_hide/vest/blue,
/turf/open/floor/plasteel/dark,
/area/ruin/powered/e1m1)
"q" = (
/turf/open/floor/plasteel/stairs/left,
/area/ruin/powered/e1m1)
"r" = (
/turf/open/floor/carpet/blue/doomed,
/area/ruin/powered/e1m1)
"s" = (
/obj/effect/spawner/structure/window/plasma/reinforced,
/turf/open/floor/carpet/blue/doomed,
/area/ruin/powered/e1m1)
"t" = (
/obj/effect/mob_spawn/human/corpse/nanotrasensoldier,
/turf/open/floor/plasteel/dark,
/area/ruin/powered/e1m1)
"u" = (
/mob/living/simple_animal/hostile/asteroid/elite/candy,
/turf/open/floor/carpet/blue/doomed,
/area/ruin/powered/e1m1)
"v" = (
/obj/structure/fermenting_barrel/doom,
/turf/open/floor/carpet/blue/doomed,
/area/ruin/powered/e1m1)
"w" = (
/obj/effect/spawner/structure/window/plasma/reinforced,
/turf/open/floor/plasteel/dark,
/area/ruin/powered/e1m1)
"x" = (
/obj/structure/rack,
/obj/item/flamethrower/full/tank,
/turf/open/floor/carpet/black,
/area/ruin/powered/e1m1)
"y" = (
/obj/structure/rack,
/obj/item/gun/energy/e_gun/old,
/turf/open/floor/carpet/black,
/area/ruin/powered/e1m1)

(1,1,1) = {"
a
a
a
a
a
a
a
a
a
a
a
a
a
i
i
i
i
i
i
a
a
a
a
a
a
"}
(2,1,1) = {"
a
a
a
a
a
a
a
a
a
a
a
a
i
i
i
i
i
i
i
i
a
a
a
a
a
"}
(3,1,1) = {"
a
a
a
a
a
a
a
a
a
a
a
i
i
i
b
o
o
b
i
i
i
a
a
a
a
"}
(4,1,1) = {"
a
a
a
a
a
a
a
a
a
a
i
i
i
i
b
g
t
b
i
i
i
i
a
a
a
"}
(5,1,1) = {"
a
a
a
a
a
a
a
a
a
a
i
i
i
b
g
g
g
g
b
i
i
i
a
a
a
"}
(6,1,1) = {"
a
a
a
a
a
a
a
a
a
a
i
i
i
b
g
p
p
g
b
i
i
i
a
a
a
"}
(7,1,1) = {"
a
a
a
a
a
a
a
a
a
a
i
i
i
b
g
p
p
g
b
i
i
i
a
a
a
"}
(8,1,1) = {"
a
a
a
a
a
a
a
a
a
a
i
i
i
b
g
g
g
g
b
i
i
i
a
a
a
"}
(9,1,1) = {"
a
a
a
a
a
a
a
a
a
a
i
i
b
g
g
g
g
g
g
b
i
i
a
a
a
"}
(10,1,1) = {"
a
a
a
a
a
a
a
a
a
a
i
i
b
g
g
g
g
g
g
b
i
i
a
a
a
"}
(11,1,1) = {"
a
a
a
a
a
a
a
a
a
a
i
i
b
g
g
g
g
g
g
b
i
i
a
a
a
"}
(12,1,1) = {"
a
a
a
a
a
a
a
a
a
a
i
i
b
b
b
q
q
b
b
b
i
i
a
a
a
"}
(13,1,1) = {"
a
a
a
a
a
a
a
a
a
a
i
i
b
a
b
q
q
b
a
b
i
i
a
a
a
"}
(14,1,1) = {"
a
a
a
a
a
a
a
a
a
a
i
i
a
a
b
q
q
b
a
a
i
i
a
a
a
"}
(15,1,1) = {"
a
a
a
a
a
a
a
a
a
a
a
a
a
b
k
g
g
k
b
a
a
a
a
a
a
"}
(16,1,1) = {"
a
a
a
a
a
a
a
a
a
a
a
a
b
k
g
g
g
g
k
b
a
a
a
a
a
"}
(17,1,1) = {"
a
a
a
a
a
a
a
a
a
a
a
b
g
g
g
g
t
g
g
g
b
a
a
a
a
"}
(18,1,1) = {"
a
a
a
a
a
a
a
a
a
a
a
b
g
l
l
g
g
l
l
g
b
a
a
a
a
"}
(19,1,1) = {"
a
a
a
a
a
a
a
a
a
a
a
b
g
l
l
g
g
l
l
g
b
a
a
a
a
"}
(20,1,1) = {"
a
a
a
a
a
a
a
a
a
a
a
b
g
g
g
g
g
g
g
g
b
a
a
a
a
"}
(21,1,1) = {"
a
a
a
a
a
a
a
a
a
a
a
a
b
g
g
g
g
g
g
b
a
a
a
a
a
"}
(22,1,1) = {"
a
a
a
a
a
a
a
a
a
a
a
a
a
b
m
g
g
m
b
a
a
a
a
a
a
"}
(23,1,1) = {"
a
a
a
a
a
a
a
a
a
a
a
b
b
b
b
q
q
b
b
b
b
b
b
a
a
"}
(24,1,1) = {"
a
a
a
a
a
a
a
a
a
a
a
b
k
j
n
g
g
n
g
g
j
k
b
a
a
"}
(25,1,1) = {"
a
a
a
a
a
a
a
a
a
a
a
b
g
g
g
g
g
g
g
g
g
g
b
a
a
"}
(26,1,1) = {"
a
a
a
a
a
a
a
a
a
a
a
b
g
g
g
g
g
g
g
g
g
g
b
a
a
"}
(27,1,1) = {"
a
a
a
a
a
a
a
a
a
a
b
g
g
g
g
g
g
g
g
g
g
g
b
a
a
"}
(28,1,1) = {"
a
a
a
a
a
a
a
a
a
b
g
g
g
g
g
g
g
g
g
g
g
g
b
a
a
"}
(29,1,1) = {"
a
a
a
a
a
a
a
a
a
b
g
g
g
g
g
g
g
j
g
g
g
g
b
a
a
"}
(30,1,1) = {"
a
a
a
a
a
a
a
a
a
b
g
g
g
g
b
g
g
g
b
g
g
g
b
a
a
"}
(31,1,1) = {"
a
a
a
a
a
a
a
a
a
b
g
g
g
g
g
r
r
r
g
g
g
g
b
a
a
"}
(32,1,1) = {"
a
a
a
a
a
a
a
a
a
b
g
g
g
g
g
r
r
r
g
g
g
g
g
b
a
"}
(33,1,1) = {"
a
a
a
a
a
a
a
a
a
b
g
g
g
g
g
r
r
r
g
g
g
g
g
g
b
"}
(34,1,1) = {"
a
a
a
a
a
a
a
a
a
b
g
g
g
g
g
r
u
r
g
g
g
g
g
t
h
"}
(35,1,1) = {"
b
b
b
b
b
b
a
a
a
b
g
g
g
g
g
r
r
r
g
g
g
g
g
g
b
"}
(36,1,1) = {"
b
c
d
d
d
b
b
b
b
b
j
g
g
g
g
r
r
r
g
g
g
g
g
g
b
"}
(37,1,1) = {"
b
d
e
f
d
h
g
g
g
h
g
g
g
g
g
r
r
r
g
g
g
g
g
b
a
"}
(38,1,1) = {"
b
d
x
y
d
h
g
g
g
h
g
g
g
g
b
r
r
r
b
g
g
g
b
a
a
"}
(39,1,1) = {"
b
d
d
d
d
b
b
b
b
b
g
g
g
g
g
r
v
r
g
g
g
k
b
a
a
"}
(40,1,1) = {"
b
b
b
b
b
b
a
a
a
b
b
b
b
b
b
s
b
s
b
w
w
b
b
a
a
"}
