//MAP CONVERTED BY dmm2tgm.py THIS HEADER COMMENT PREVENTS RECONVERSION, DO NOT REMOVE
"a" = (
/turf/closed/indestructible/syndicate,
/area/ruin/powered)
"b" = (
/turf/open/floor/circuit/red/anim,
/area/ruin/powered)
"c" = (
/turf/open/floor/circuit/green/anim,
/area/ruin/powered)
"d" = (
/turf/open/floor/circuit,
/area/ruin/powered)
"e" = (
/mob/living/simple_animal/hostile/megafauna/rogueprocess,
/turf/open/floor/circuit,
/area/ruin/powered)
"f" = (
/obj/machinery/door/airlock/rogue,
/turf/open/floor/circuit/red/anim,
/area/ruin/powered)

(1,1,1) = {"
a
a
a
a
a
a
a
a
a
a
a
a
a
a
a
a
a
a
a
a
"}
(2,1,1) = {"
a
b
b
b
b
b
b
b
b
b
b
b
b
b
b
b
b
b
b
a
"}
(3,1,1) = {"
a
b
b
b
b
b
b
b
b
b
b
b
b
b
b
b
b
b
b
a
"}
(4,1,1) = {"
a
b
b
b
b
b
b
b
b
b
b
b
b
b
b
b
b
b
b
a
"}
(5,1,1) = {"
a
b
b
b
b
b
b
b
b
b
b
b
b
b
b
b
b
b
b
a
"}
(6,1,1) = {"
a
b
b
b
b
b
b
b
b
b
b
b
b
b
b
b
b
b
b
a
"}
(7,1,1) = {"
a
b
b
b
b
b
b
b
b
b
b
b
b
b
b
b
b
b
b
a
"}
(8,1,1) = {"
a
b
b
b
b
b
b
b
c
c
c
c
c
b
b
b
b
b
b
a
"}
(9,1,1) = {"
a
b
b
b
b
b
b
b
c
d
d
d
c
b
b
b
b
b
b
a
"}
(10,1,1) = {"
a
b
b
b
b
b
b
b
c
d
e
d
c
b
b
b
b
b
b
f
"}
(11,1,1) = {"
a
b
b
b
b
b
b
b
c
d
d
d
c
b
b
b
b
b
b
a
"}
(12,1,1) = {"
a
b
b
b
b
b
b
b
c
c
c
c
c
b
b
b
b
b
b
a
"}
(13,1,1) = {"
a
b
b
b
b
b
b
b
b
b
b
b
b
b
b
b
b
b
b
a
"}
(14,1,1) = {"
a
b
b
b
b
b
b
b
b
b
b
b
b
b
b
b
b
b
b
a
"}
(15,1,1) = {"
a
b
b
b
b
b
b
b
b
b
b
b
b
b
b
b
b
b
b
a
"}
(16,1,1) = {"
a
b
b
b
b
b
b
b
b
b
b
b
b
b
b
b
b
b
b
a
"}
(17,1,1) = {"
a
b
b
b
b
b
b
b
b
b
b
b
b
b
b
b
b
b
b
a
"}
(18,1,1) = {"
a
b
b
b
b
b
b
b
b
b
b
b
b
b
b
b
b
b
b
a
"}
(19,1,1) = {"
a
b
b
b
b
b
b
b
b
b
b
b
b
b
b
b
b
b
b
a
"}
(20,1,1) = {"
a
a
a
a
a
a
a
a
a
a
a
a
a
a
a
a
a
a
a
a
"}
