"a" = (/turf/open/floor/plating/asteroid/snow/icemoon,/area/ruin/unpowered)
"b" = (/turf/closed/wall/mineral/snow,/area/ruin/unpowered)
"c" = (/obj/structure/bed/dogbed,/turf/open/floor/plating/asteroid/snow/icemoon,/area/ruin/unpowered)
"d" = (/obj/effect/mob_spawn/human/corpse/russian,/turf/open/floor/plating/asteroid/snow/icemoon,/area/ruin/unpowered)
"e" = (/obj/item/clothing/suit/armor/vest/russian,/turf/open/floor/plating/asteroid/snow/icemoon,/area/ruin/unpowered)
"f" = (/obj/item/kitchen/knife/combat/survival,/turf/open/floor/plating/asteroid/snow/icemoon,/area/ruin/unpowered)
"g" = (/obj/structure/bonfire,/turf/open/floor/plating/asteroid/snow/icemoon,/area/ruin/unpowered)
"h" = (/mob/living/simple_animal/hostile/bear/russian,/turf/open/floor/plating/asteroid/snow/icemoon,/area/ruin/unpowered)
"i" = (/obj/item/clothing/suit/armor/navyblue/russian,/turf/open/floor/plating/asteroid/snow/icemoon,/area/ruin/unpowered)
"j" = (/mob/living/simple_animal/hostile/russian,/turf/open/floor/plating/asteroid/snow/icemoon,/area/ruin/unpowered)
"k" = (/obj/item/reagent_containers/food/drinks/bottle/vodka/badminka,/turf/open/floor/plating/asteroid/snow/icemoon,/area/ruin/unpowered)
"l" = (/obj/item/reagent_containers/food/drinks/bottle/vodka,/turf/open/floor/plating/asteroid/snow/icemoon,/area/ruin/unpowered)

(1,1,1) = {"
aaabbbbaaa
aabbbbbbaa
aabbcabbaa
abbedhabba
abbifkabba
bbbaaglaba
bbbjaaabba
abbaaabbaa
aaaaaaaaaa
aaaaaaaaaa
"}
