//MAP CONVERTED BY dmm2tgm.py THIS HEADER COMMENT PREVENTS RECONVERSION, DO NOT REMOVE
"b" = (
/obj/structure/fans,
/turf/open/floor/pod/dark,
/area/ruin/powered)
"c" = (
/obj/effect/mob_spawn/human/miner/explorer,
/obj/effect/decal/cleanable/dirt,
/obj/effect/decal/cleanable/blood/old,
/turf/open/floor/pod/dark,
/area/ruin/powered)
"h" = (
/obj/machinery/door/airlock/survival_pod/glass,
/obj/structure/fans/tiny,
/obj/structure/barricade/wooden/crude/snow,
/turf/open/floor/pod/dark,
/area/ruin/powered)
"i" = (
/obj/structure/table/reinforced,
/obj/effect/spawner/lootdrop/mre,
/turf/open/floor/pod/dark,
/area/ruin/powered)
"j" = (
/obj/item/gps/computer{
	gpstag = "Distress Signal"
	},
/turf/open/floor/pod/dark,
/area/ruin/powered)
"k" = (
/mob/living/simple_animal/hostile/skeleton/plasmaminer,
/turf/open/floor/plating/asteroid/snow/icemoon,
/area/icemoon/surface/outdoors/explored)
"l" = (
/obj/machinery/smartfridge/survival_pod,
/turf/open/floor/pod/dark,
/area/ruin/powered)
"m" = (
/obj/effect/decal/cleanable/dirt,
/obj/effect/decal/cleanable/blood/old{
	dir = 10;
	icon_state = "trails_1";
	name = "dried blood trail"
	},
/turf/open/floor/pod/dark,
/area/ruin/powered)
"o" = (
/obj/structure/fluff/empty_cryostasis_sleeper,
/obj/machinery/light/small{
	dir = 8
	},
/turf/open/floor/pod/dark,
/area/ruin/powered)
"p" = (
/obj/effect/decal/cleanable/dirt,
/turf/open/floor/pod/dark,
/area/ruin/powered)
"q" = (
/obj/effect/decal/cleanable/blood/old,
/obj/effect/decal/cleanable/blood/old{
	dir = 8;
	icon_state = "trails_1";
	name = "dried blood trail"
	},
/turf/open/floor/plating/asteroid/snow/icemoon,
/area/icemoon/surface/outdoors/explored)
"r" = (
/obj/effect/decal/cleanable/dirt,
/obj/effect/decal/cleanable/dirt,
/turf/open/floor/pod/dark,
/area/ruin/powered)
"s" = (
/obj/structure/tubes,
/obj/machinery/light/small{
	dir = 4
	},
/turf/open/floor/pod/dark,
/area/ruin/powered)
"t" = (
/turf/open/floor/pod/dark,
/area/ruin/powered)
"u" = (
/obj/effect/decal/cleanable/blood/old{
	name = "dried blood splatter";
	pixel_x = -29
	},
/turf/open/floor/plating/asteroid/snow/icemoon,
/area/icemoon/surface/outdoors/explored)
"v" = (
/obj/structure/bed/pod{
	name = "bed"
	},
/obj/item/bedsheet/black,
/turf/open/floor/pod/dark,
/area/ruin/powered)
"w" = (
/obj/effect/decal/cleanable/dirt,
/obj/effect/decal/cleanable/generic,
/obj/effect/decal/cleanable/blood/old{
	dir = 8;
	icon_state = "trails_1";
	name = "dried blood trail"
	},
/turf/open/floor/pod/dark,
/area/ruin/powered)
"B" = (
/obj/structure/ore_box,
/turf/open/floor/pod/dark,
/area/ruin/powered)
"E" = (
/obj/effect/decal/cleanable/dirt,
/obj/effect/decal/cleanable/blood/old{
	dir = 8;
	icon_state = "trails_1";
	name = "dried blood trail"
	},
/turf/open/floor/pod/dark,
/area/ruin/powered)
"G" = (
/obj/effect/decal/cleanable/blood/old{
	dir = 8;
	icon_state = "trails_1";
	name = "dried blood trail"
	},
/turf/open/floor/plating/asteroid/snow/icemoon,
/area/icemoon/surface/outdoors/explored)
"J" = (
/turf/template_noop,
/area/template_noop)
"K" = (
/obj/machinery/vending/sustenance,
/turf/open/floor/pod/dark,
/area/ruin/powered)
"L" = (
/obj/machinery/sleeper/survival_pod,
/turf/open/floor/pod/dark,
/area/ruin/powered)
"N" = (
/turf/open/lava/plasma/ice_moon,
/area/icemoon/surface/outdoors/explored)
"O" = (
/obj/effect/spawner/lootdrop/crate_spawner,
/turf/open/floor/pod/dark,
/area/ruin/powered)
"Q" = (
/turf/open/floor/plating/asteroid/snow/icemoon,
/area/icemoon/surface/outdoors/explored)
"R" = (
/obj/effect/decal/cleanable/dirt,
/obj/effect/decal/cleanable/blood/old{
	icon_state = "trails_1";
	name = "dried blood trail"
	},
/turf/open/floor/pod/dark,
/area/ruin/powered)
"S" = (
/turf/closed/wall/mineral/titanium/survival/pod,
/area/ruin/powered)
"T" = (
/obj/machinery/vending/wallmed,
/turf/closed/wall/mineral/titanium/survival/pod,
/area/ruin/powered)
"W" = (
/obj/structure/fluff/empty_cryostasis_sleeper,
/turf/open/floor/pod/dark,
/area/ruin/powered)
"X" = (
/obj/effect/decal/cleanable/dirt,
/obj/effect/decal/cleanable/blood/old,
/turf/open/floor/pod/dark,
/area/ruin/powered)
"Y" = (
/obj/structure/table/reinforced,
/obj/machinery/light{
	dir = 4
	},
/turf/open/floor/pod/dark,
/area/ruin/powered)
"Z" = (
/obj/structure/table/reinforced,
/obj/effect/spawner/lootdrop/glowstick,
/turf/open/floor/pod/dark,
/area/ruin/powered)

(1,1,1) = {"
J
J
J
J
J
J
Q
Q
Q
Q
J
J
J
J
J
"}
(2,1,1) = {"
J
S
S
S
S
S
S
S
Q
Q
Q
Q
J
J
J
"}
(3,1,1) = {"
J
S
b
L
S
o
W
S
Q
Q
Q
Q
Q
Q
Q
"}
(4,1,1) = {"
J
S
l
X
R
m
p
S
Q
Q
Q
N
N
Q
Q
"}
(5,1,1) = {"
Q
S
j
s
T
w
p
h
Q
Q
Q
N
N
N
Q
"}
(6,1,1) = {"
Q
S
S
S
S
E
p
S
k
Q
N
N
N
N
Q
"}
(7,1,1) = {"
Q
S
B
t
O
E
t
S
Q
Q
N
N
N
N
Q
"}
(8,1,1) = {"
Q
S
B
t
p
c
p
S
G
Q
N
N
N
N
Q
"}
(9,1,1) = {"
Q
S
i
p
p
r
p
S
G
Q
N
N
N
N
Q
"}
(10,1,1) = {"
J
S
Z
K
v
Y
v
S
G
Q
N
N
N
N
Q
"}
(11,1,1) = {"
J
S
S
S
S
S
S
S
G
Q
N
N
N
N
Q
"}
(12,1,1) = {"
J
J
J
Q
Q
Q
Q
Q
q
u
N
N
N
Q
Q
"}
(13,1,1) = {"
J
J
J
J
J
Q
Q
Q
Q
Q
Q
N
N
Q
Q
"}
(14,1,1) = {"
J
J
J
J
J
J
Q
Q
Q
Q
Q
N
N
Q
J
"}
(15,1,1) = {"
J
J
J
J
J
J
J
J
J
Q
Q
Q
Q
Q
J
"}
