"a" = (/turf/template_noop,/area/template_noop)
"b" = (/turf/open/floor/plating/ice/icemoon,/area/snowplanet/underground/outdoors/ruin)
"c" = (/obj/structure/flora/rock/icy,/turf/open/floor/plating/ice/icemoon,/area/snowplanet/underground/outdoors/ruin)
"d" = (/obj/item/flashlight/lantern{on = 1},/turf/open/floor/plating/ice/icemoon,/area/snowplanet/underground/outdoors/ruin)
"e" = (/obj/item/kitchen/knife/combat/survival,/turf/open/floor/plating/ice/icemoon,/area/snowplanet/underground/outdoors/ruin)
"f" = (/obj/item/clothing/suit/hooded/explorer,/obj/effect/decal/cleanable/blood/gibs/up,/turf/open/floor/plating/ice/icemoon,/area/snowplanet/underground/outdoors/ruin)
"g" = (/obj/item/clothing/shoes/winterboots/ice_boots,/turf/open/floor/plating/ice/icemoon,/area/snowplanet/underground/outdoors/ruin)

(1,1,1) = {"
aaaaaaaaaaaaaaaaaaaaaaaaaaaaa
aaaaaaabbbbbbbbbbbbbbbbaaaaaa
aaaaabbbbbbbbbbbbcbbbbbbaaaaa
aaaabbbcbbbbbbbbbbbbbbbbbaaaa
aaabbbbbbbbbcbbbbbbbbbcbbbaaa
aabbbbbbbbbbbbbbbbbbbbbbbbbaa
aabbbbbbbbbbbbbbbbbbbbbdbbbaa
abbbbbbbbbbbbbbbbcbbbbbefgbba
abbbcbbbcbbbbbbbbbbbbbbbbbbba
abbbbbbbbbbbbbbbbbbbbbbbbcbba
abbbbbbbbbbcbbbcbbbbbcbbbbbba
abbbbbbbbbbbbbbbbbbbbbbbbbbba
abcbbbbbbbbbbbbbbbbbbbbbbbbba
abbbbbcbbbbbbbbbbbbbbbbbbbbba
abbbbbbbbbbbbbbbbbbcbbbbbcbba
abbbbbbbbbbbbbcbbbbbbbbbbbbba
abbbcbbbbbbbbbbbbbbbbbbbbbbba
abbbbbbbcbbbbbbbbbbbbbbbbbbba
aabbbbbbbbbbbbbbbbbbbbcbbbbaa
aaabbbcbbbbbbbbbbbbbbbbbbbaaa
aaaabbbbbbbbcbbbbcbbbbbbbaaaa
aaaaabbbbbbbbbbbbbbbbbbbaaaaa
aaaaaabbcbbbbbbbbbbbbbbaaaaaa
aaaaaaaabbbbbbbbbbbbbbaaaaaaa
aaaaaaaaaaaaaaaaaaaaaaaaaaaaa
"}
