//MAP CONVERTED BY dmm2tgm.py THIS HEADER COMMENT PREVENTS RECONVERSION, DO NOT REMOVE
"a" = (
/obj/structure/ice_walkers,
/turf/open/floor/plating/asteroid/snow/icemoon,
/area/ruin/unpowered/icemoon/underground)
"b" = (
/obj/structure/table/wood,
/turf/open/floor/plating/snowed/smoothed/icemoon,
/area/ruin/unpowered/icemoon/underground)
"c" = (
/obj/structure/table/wood,
/obj/item/mining_scanner,
/obj/item/pickaxe/plasteel,
/obj/item/storage/bag/ore,
/obj/item/flashlight/lantern,
/turf/open/floor/plating/snowed/smoothed/icemoon,
/area/ruin/unpowered/icemoon/underground)
"d" = (
/obj/effect/decal/cleanable/dirt,
/obj/item/storage/wallet/random,
/turf/open/floor/plating,
/area/ruin/unpowered/icemoon/underground)
"e" = (
/obj/structure/closet/cabinet,
/obj/item/clothing/under/color/grey/glorf,
/obj/item/clothing/suit/hooded/wintercoat/miner{
	name = "ancient mining winter coat"
	},
/obj/item/clothing/shoes/workboots/mining,
/turf/open/floor/plating/snowed/smoothed/icemoon,
/area/ruin/unpowered/icemoon/underground)
"f" = (
/obj/structure/showcase/machinery/cloning_pod{
	desc = "A broken down tube, whatever it used to contain is long gone.";
	name = "broken cryo tube"
	},
/obj/effect/decal/cleanable/dirt,
/turf/open/floor/plasteel/white,
/area/ruin/unpowered/icemoon/underground)
"g" = (
/obj/structure/closet/cabinet,
/obj/item/clothing/under/color/grey/glorf,
/obj/item/clothing/suit/hooded/wintercoat/miner{
	name = "ancient mining winter coat"
	},
/obj/item/clothing/shoes/workboots/mining,
/obj/item/storage/belt/mining/vendor,
/turf/open/floor/plating/snowed/smoothed/icemoon,
/area/ruin/unpowered/icemoon/underground)
"h" = (
/obj/structure/mineral_door/woodrustic,
/turf/open/floor/plating/snowed/smoothed/icemoon,
/area/ruin/unpowered/icemoon/underground)
"i" = (
/obj/item/stack/rods,
/obj/effect/decal/cleanable/dirt,
/turf/open/floor/plasteel/white,
/area/ruin/unpowered/icemoon/underground)
"j" = (
/turf/closed/mineral/snowmountain/cavern/icemoon,
/area/ruin/unpowered/icemoon/underground)
"l" = (
/turf/open/floor/plating/ice/icemoon/slippery,
/area/ruin/unpowered/icemoon/underground)
"m" = (
/turf/open/floor/plating/asteroid/snow/ice/icemoon,
/area/ruin/unpowered/icemoon/underground)
"n" = (
/obj/structure/closet/cabinet,
/obj/item/clothing/under/color/grey/glorf,
/obj/item/clothing/suit/hooded/wintercoat/miner{
	name = "ancient mining winter coat"
	},
/obj/item/clothing/shoes/workboots/mining,
/obj/item/twohanded/bonespear,
/turf/open/floor/plating/snowed/smoothed/icemoon,
/area/ruin/unpowered/icemoon/underground)
"o" = (
/obj/structure/table/wood,
/obj/item/flashlight/lantern,
/turf/open/floor/plating/snowed/smoothed/icemoon,
/area/ruin/unpowered/icemoon/underground)
"p" = (
/obj/structure/barricade/wooden/snowed,
/turf/open/floor/plating/asteroid/snow/icemoon,
/area/ruin/unpowered/icemoon/underground)
"r" = (
/obj/effect/decal/cleanable/dirt,
/turf/open/floor/plasteel/white,
/area/ruin/unpowered/icemoon/underground)
"s" = (
/obj/item/soap/homemade,
/turf/open/floor/plating/snowed/smoothed/icemoon,
/area/ruin/unpowered/icemoon/underground)
"t" = (
/obj/structure/bonfire/prelit,
/turf/open/floor/plating/snowed/smoothed/icemoon,
/area/ruin/unpowered/icemoon/underground)
"u" = (
/obj/machinery/grill,
/turf/open/floor/plating/snowed/smoothed/icemoon,
/area/ruin/unpowered/icemoon/underground)
"v" = (
/turf/closed/wall/rust,
/area/ruin/unpowered/icemoon/underground)
"w" = (
/obj/structure/fluff/fokoff_sign,
/turf/open/floor/plating/asteroid/snow/icemoon,
/area/ruin/unpowered/icemoon/underground)
"x" = (
/obj/structure/showcase/horrific_experiment,
/obj/effect/decal/cleanable/dirt,
/turf/open/floor/plasteel/white,
/area/ruin/unpowered/icemoon/underground)
"y" = (
/turf/template_noop,
/area/template_noop)
"A" = (
/turf/open/floor/plating/snowed/smoothed/icemoon,
/area/ruin/unpowered/icemoon/underground)
"B" = (
/obj/structure/mineral_door/woodrustic,
/turf/open/floor/plating/asteroid/snow/icemoon,
/area/ruin/unpowered/icemoon/underground)
"E" = (
/obj/structure/frame/machine,
/obj/item/circuitboard/machine/cryo_tube,
/obj/effect/decal/cleanable/dirt,
/obj/effect/decal/cleanable/glass,
/turf/open/floor/plasteel/white,
/area/ruin/unpowered/icemoon/underground)
"F" = (
/obj/effect/decal/cleanable/generic,
/turf/open/floor/plating,
/area/ruin/unpowered/icemoon/underground)
"H" = (
/obj/structure/flora/rock/icy,
/turf/open/floor/plating/asteroid/snow/icemoon,
/area/ruin/unpowered/icemoon/underground)
"J" = (
/turf/open/floor/plating/asteroid/snow/icemoon,
/area/ruin/unpowered/icemoon/underground)
"K" = (
/obj/structure/barricade/wooden/snowed,
/turf/closed/wall/mineral/snow,
/area/ruin/unpowered/icemoon/underground)
"L" = (
/obj/structure/closet/cabinet,
/obj/item/clothing/under/color/grey/glorf,
/obj/item/clothing/suit/hooded/wintercoat/miner{
	name = "ancient mining winter coat"
	},
/obj/item/clothing/shoes/workboots/mining,
/obj/item/storage/belt/mining/vendor,
/obj/item/twohanded/bonespear,
/turf/open/floor/plating/snowed/smoothed/icemoon,
/area/ruin/unpowered/icemoon/underground)
"M" = (
/turf/open/floor/plating,
/area/ruin/unpowered/icemoon/underground)
"O" = (
/obj/structure/table/wood,
/obj/machinery/microwave,
/turf/open/floor/plating/snowed/smoothed/icemoon,
/area/ruin/unpowered/icemoon/underground)
"Q" = (
/obj/effect/decal/cleanable/dirt,
/turf/open/floor/plating,
/area/ruin/unpowered/icemoon/underground)
"R" = (
/obj/effect/decal/cleanable/dirt,
/obj/effect/decal/cleanable/vomit/old,
/obj/item/clothing/under/colonistjumpsuit,
/turf/open/floor/plasteel/white,
/area/ruin/unpowered/icemoon/underground)
"V" = (
/obj/structure/table/wood,
/obj/item/pickaxe/drill,
/obj/item/storage/bag/ore/large,
/obj/item/flashlight/lantern,
/turf/open/floor/plating/snowed/smoothed/icemoon,
/area/ruin/unpowered/icemoon/underground)
"W" = (
/turf/closed/wall/mineral/snow,
/area/ruin/unpowered/icemoon/underground)

(1,1,1) = {"
j
j
j
j
j
j
j
j
j
j
j
j
j
j
j
W
W
W
W
W
j
j
j
j
j
j
j
j
j
j
"}
(2,1,1) = {"
j
j
j
j
j
j
j
j
j
j
j
j
j
j
W
W
A
A
A
W
W
j
j
j
j
j
J
J
j
j
"}
(3,1,1) = {"
j
j
j
j
j
j
j
j
j
j
j
j
j
W
W
u
A
A
A
A
W
W
j
j
j
J
J
J
j
j
"}
(4,1,1) = {"
j
j
j
j
j
j
j
j
j
j
j
j
j
W
O
A
A
A
A
A
A
W
j
j
j
J
J
J
J
j
"}
(5,1,1) = {"
j
j
j
j
j
j
j
j
j
j
j
j
j
W
b
A
A
t
A
A
A
W
j
j
j
J
J
J
J
j
"}
(6,1,1) = {"
j
j
W
W
W
W
W
W
W
j
j
j
j
W
o
A
A
A
A
A
A
W
j
j
j
J
J
J
J
j
"}
(7,1,1) = {"
j
W
W
n
L
A
n
n
W
W
j
j
j
W
W
A
A
A
A
A
W
W
p
j
j
K
J
J
J
j
"}
(8,1,1) = {"
W
W
e
A
A
A
A
A
g
W
W
j
j
j
W
W
A
A
A
W
W
J
J
J
J
K
J
J
J
j
"}
(9,1,1) = {"
W
W
W
W
W
A
W
W
W
W
W
j
j
j
j
W
W
A
W
W
J
J
J
J
J
K
J
J
J
j
"}
(10,1,1) = {"
W
A
A
A
A
A
A
A
A
A
W
W
j
j
j
j
W
h
W
J
J
J
J
J
J
j
J
J
J
j
"}
(11,1,1) = {"
W
A
A
A
A
A
A
A
A
A
A
h
J
J
j
j
J
J
J
J
J
m
J
J
p
j
j
J
J
J
"}
(12,1,1) = {"
W
W
W
W
W
A
A
A
A
A
W
W
J
J
J
J
J
J
J
m
m
l
m
J
p
j
j
J
J
J
"}
(13,1,1) = {"
W
A
A
A
A
A
A
A
A
A
W
J
J
J
J
J
J
m
m
l
l
l
l
m
j
j
j
J
J
J
"}
(14,1,1) = {"
W
W
A
s
W
A
A
A
A
W
W
J
J
J
J
J
m
l
l
l
l
l
m
J
j
j
j
J
J
J
"}
(15,1,1) = {"
j
W
W
A
W
o
o
b
W
W
J
J
J
J
J
m
l
l
l
l
m
l
J
J
j
j
j
J
J
J
"}
(16,1,1) = {"
j
j
W
W
W
W
W
W
W
J
J
J
J
J
J
J
m
m
m
m
J
J
J
J
j
j
j
J
J
J
"}
(17,1,1) = {"
j
j
j
j
j
j
j
J
J
J
J
J
J
J
J
J
J
j
j
j
J
J
J
J
j
j
j
J
J
J
"}
(18,1,1) = {"
j
v
v
v
v
v
j
J
J
J
J
J
J
J
J
j
j
j
j
j
j
J
J
J
J
j
J
J
J
y
"}
(19,1,1) = {"
j
v
x
r
i
Q
j
J
J
H
J
J
J
J
j
j
j
j
j
j
j
j
W
B
W
W
J
J
J
y
"}
(20,1,1) = {"
j
v
f
R
F
j
j
j
J
J
J
J
J
J
j
j
j
j
j
j
j
j
w
J
J
J
J
J
J
y
"}
(21,1,1) = {"
j
v
E
Q
Q
Q
M
j
J
J
J
J
J
J
j
j
j
j
j
j
j
j
J
J
J
J
J
J
J
y
"}
(22,1,1) = {"
j
v
x
r
d
M
j
j
J
J
J
J
J
J
j
j
j
j
j
j
j
J
J
J
J
J
J
J
y
y
"}
(23,1,1) = {"
j
v
v
v
v
v
v
j
J
J
J
J
J
J
W
j
j
j
j
j
J
J
J
J
J
J
J
J
y
y
"}
(24,1,1) = {"
j
j
j
j
j
j
j
j
W
J
J
J
J
J
W
J
J
J
J
J
J
J
J
J
J
J
J
J
y
y
"}
(25,1,1) = {"
j
j
j
j
j
j
W
W
W
J
J
J
J
J
W
J
J
J
H
J
J
J
J
J
J
J
J
J
y
y
"}
(26,1,1) = {"
j
j
c
c
c
c
A
A
W
J
J
J
J
J
W
J
J
J
J
J
J
J
J
J
J
J
y
y
y
y
"}
(27,1,1) = {"
j
A
A
A
A
A
A
A
W
J
J
J
J
J
B
J
J
J
J
J
J
J
J
y
y
y
y
y
y
y
"}
(28,1,1) = {"
j
A
A
A
A
A
A
A
h
J
J
J
J
J
W
J
J
J
J
J
J
J
J
y
y
y
y
y
y
y
"}
(29,1,1) = {"
j
A
A
A
A
A
A
A
W
J
J
J
J
J
W
J
J
J
J
J
J
J
y
y
y
y
y
y
y
y
"}
(30,1,1) = {"
j
j
j
W
W
A
A
A
W
J
J
J
J
J
W
J
J
J
J
J
y
y
y
y
y
y
y
y
y
y
"}
(31,1,1) = {"
j
j
j
j
j
W
V
V
W
J
J
J
a
J
W
J
J
J
y
y
y
y
y
y
y
y
y
y
y
y
"}
(32,1,1) = {"
j
j
j
j
j
j
j
j
W
J
J
J
J
J
W
J
J
y
y
y
y
y
y
y
y
y
y
y
y
y
"}
(33,1,1) = {"
j
j
j
j
j
j
j
j
j
j
j
W
W
W
W
J
J
y
y
y
y
y
y
y
y
y
y
y
y
y
"}
(34,1,1) = {"
j
j
j
j
j
j
j
j
j
j
j
j
j
J
J
J
y
y
y
y
y
y
y
y
y
y
y
y
y
y
"}
(35,1,1) = {"
j
j
j
j
j
j
j
j
j
j
j
j
j
j
J
J
y
y
y
y
y
y
y
y
y
y
y
y
y
y
"}
