//MAP CONVERTED BY dmm2tgm.py THIS HEADER COMMENT PREVENTS RECONVERSION, DO NOT REMOVE
"a" = (
/turf/closed/mineral/random/high_chance/snow,
/area/ruin/powered)
"b" = (
/obj/structure/window/reinforced/tinted/frosted{
	dir = 8
	},
/obj/structure/window/reinforced/tinted/frosted{
	dir = 6
	},
/obj/machinery/pool/drain,
/obj/machinery/light{
	dir = 1
	},
/turf/open/pool,
/area/ruin/powered)
"c" = (
/obj/structure/window/reinforced/tinted/frosted{
	dir = 6
	},
/obj/machinery/pool/drain,
/turf/open/pool,
/area/ruin/powered)
"d" = (
/obj/structure/window/reinforced/tinted/frosted{
	dir = 4
	},
/obj/structure/window/reinforced/tinted/frosted{
	dir = 6
	},
/obj/machinery/pool/drain,
/obj/machinery/light{
	dir = 1
	},
/turf/open/pool,
/area/ruin/powered)
"e" = (
/obj/structure/window/reinforced/tinted/frosted{
	dir = 8
	},
/turf/open/pool,
/area/ruin/powered)
"f" = (
/turf/open/pool,
/area/ruin/powered)
"g" = (
/obj/structure/window/reinforced/tinted/frosted{
	dir = 4
	},
/turf/open/pool,
/area/ruin/powered)
"h" = (
/obj/machinery/pool/filter,
/obj/structure/window/reinforced/tinted/frosted,
/obj/structure/window/reinforced/tinted/frosted{
	dir = 8
	},
/turf/open/pool,
/area/ruin/powered)
"i" = (
/obj/machinery/pool/filter,
/obj/structure/window/reinforced/tinted/frosted,
/obj/structure/window/reinforced/tinted/frosted{
	dir = 4
	},
/turf/open/pool,
/area/ruin/powered)
"j" = (
/obj/item/toy/poolnoodle,
/turf/open/floor/plating/asteroid/snow/icemoon,
/area/ruin/powered)
"k" = (
/turf/open/floor/plating/asteroid/snow/icemoon,
/area/ruin/powered)
"l" = (
/obj/machinery/pool/controller,
/turf/open/floor/plating/asteroid/snow/icemoon,
/area/ruin/powered)
"m" = (
/obj/item/reagent_containers/glass/bottle/cryoxadone,
/turf/open/floor/plating/asteroid/snow/icemoon,
/area/ruin/powered)
"n" = (
/obj/item/reagent_containers/glass/beaker/synthflesh,
/turf/open/floor/plating/asteroid/snow/icemoon,
/area/ruin/powered)
"o" = (
/obj/item/reagent_containers/food/drinks/bottle/holywater,
/obj/item/reagent_containers/pill/penis_enlargement,
/turf/open/floor/plating/asteroid/snow/icemoon,
/area/ruin/powered)

(1,1,1) = {"
a
a
a
a
a
a
a
a
a
k
"}
(2,1,1) = {"
a
a
a
a
a
a
a
a
k
k
"}
(3,1,1) = {"
a
a
b
e
e
e
h
j
k
k
"}
(4,1,1) = {"
a
a
c
f
f
f
f
k
k
k
"}
(5,1,1) = {"
a
a
c
f
f
f
f
k
k
k
"}
(6,1,1) = {"
a
a
c
f
f
f
f
k
k
k
"}
(7,1,1) = {"
a
a
c
f
f
f
f
k
m
k
"}
(8,1,1) = {"
a
a
d
g
g
g
i
l
n
k
"}
(9,1,1) = {"
a
a
a
a
a
a
a
a
o
k
"}
(10,1,1) = {"
a
a
a
a
a
a
a
a
a
k
"}
