//MAP CONVERTED BY dmm2tgm.py THIS HEADER COMMENT PREVENTS RECONVERSION, DO NOT REMOVE
"a" = (
/obj/structure/chair/brass,
/mob/living/simple_animal/hostile/megafauna/kingclown,
/turf/open/floor/mineral/bananium,
/area/ruin/powered/icemoon/underground)
"b" = (
/obj/structure/chair/brass,
/mob/living/simple_animal/hostile/retaliate/clown/banana{
	name = "Queen Clown";
	wander = 0
	},
/turf/open/floor/mineral/bananium,
/area/ruin/powered/icemoon/underground)
"c" = (
/turf/open/floor/mineral/titanium/yellow,
/area/ruin/powered/icemoon/underground)
"d" = (
/mob/living/simple_animal/hostile/retaliate/clown,
/turf/open/floor/mineral/bananium,
/area/ruin/powered/icemoon/underground)
"e" = (
/mob/living/simple_animal/hostile/retaliate/clown/longface,
/turf/open/floor/mineral/bananium,
/area/ruin/powered/icemoon/underground)
"i" = (
/turf/open/floor/noslip,
/area/ruin/powered/icemoon/underground)
"j" = (
/turf/open/floor/mineral/bananium,
/area/ruin/powered/icemoon/underground)
"k" = (
/turf/template_noop,
/area/template_noop)
"l" = (
/mob/living/simple_animal/hostile/retaliate/clown/honkling,
/turf/open/floor/mineral/bananium,
/area/ruin/powered/icemoon/underground)
"n" = (
/obj/structure/barricade/wooden/crude/snow,
/obj/machinery/door/airlock/hatch,
/turf/open/floor/noslip,
/area/ruin/powered/icemoon/underground)
"q" = (
/turf/closed/indestructible/riveted/uranium,
/area/ruin/powered/icemoon/underground)
"t" = (
/turf/open/floor/mineral/gold,
/area/ruin/powered/icemoon/underground)
"w" = (
/obj/structure/table/bronze,
/turf/open/floor/grass/fairy/purple,
/area/ruin/powered/icemoon/underground)
"x" = (
/obj/structure/chair,
/turf/open/floor/grass/fairy/yellow,
/area/ruin/powered/icemoon/underground)
"y" = (
/mob/living/simple_animal/hostile/retaliate/clown/clownhulk/honcmunculus,
/turf/open/floor/mineral/bananium,
/area/ruin/powered/icemoon/underground)
"z" = (
/obj/structure/statue/bananium/clown,
/turf/open/floor/mineral/bananium,
/area/ruin/powered/icemoon/underground)
"A" = (
/mob/living/simple_animal/hostile/retaliate/clown,
/turf/open/floor/mineral/titanium/yellow,
/area/ruin/powered/icemoon/underground)
"C" = (
/obj/structure/chair,
/mob/living/simple_animal/hostile/retaliate/clown,
/turf/open/floor/grass/fairy/yellow,
/area/ruin/powered/icemoon/underground)
"D" = (
/mob/living/simple_animal/hostile/retaliate/clown/fleshclown,
/turf/open/floor/mineral/bananium,
/area/ruin/powered/icemoon/underground)
"F" = (
/turf/open/floor/grass/fairy/purple,
/area/ruin/powered/icemoon/underground)
"G" = (
/obj/structure/statue/bananium/clown,
/turf/open/floor/mineral/diamond,
/area/ruin/powered/icemoon/underground)
"I" = (
/mob/living/simple_animal/hostile/retaliate/clown/mutant,
/turf/open/floor/mineral/bananium,
/area/ruin/powered/icemoon/underground)
"M" = (
/obj/structure/chair,
/mob/living/simple_animal/hostile/retaliate/clown/mutant/blob,
/turf/open/floor/grass/fairy/yellow,
/area/ruin/powered/icemoon/underground)
"N" = (
/mob/living/simple_animal/hostile/retaliate/clown/mutant/blob,
/turf/open/floor/mineral/bananium,
/area/ruin/powered/icemoon/underground)
"O" = (
/turf/open/floor/mineral/silver,
/area/ruin/powered/icemoon/underground)
"P" = (
/mob/living/simple_animal/hostile/retaliate/clown,
/turf/open/floor/mineral/silver,
/area/ruin/powered/icemoon/underground)
"Q" = (
/obj/machinery/door/airlock/glass_large,
/turf/open/floor/mineral/titanium/yellow,
/area/ruin/powered/icemoon/underground)
"R" = (
/mob/living/simple_animal/hostile/retaliate/clown/fleshclown,
/turf/open/floor/mineral/silver,
/area/ruin/powered/icemoon/underground)
"S" = (
/mob/living/simple_animal/hostile/retaliate/clown,
/turf/open/floor/noslip,
/area/ruin/powered/icemoon/underground)
"U" = (
/mob/living/simple_animal/banana_spider,
/turf/open/floor/noslip,
/area/ruin/powered/icemoon/underground)
"V" = (
/obj/structure/table/bronze,
/turf/open/floor/noslip,
/area/ruin/powered/icemoon/underground)

(1,1,1) = {"
k
k
k
k
k
k
k
k
k
k
k
k
k
k
k
k
k
k
k
k
k
k
k
k
k
k
k
k
k
k
"}
(2,1,1) = {"
k
k
k
k
k
k
q
q
q
q
q
q
q
q
q
q
q
q
q
q
q
q
q
q
k
k
k
k
k
k
"}
(3,1,1) = {"
k
k
k
k
q
q
q
j
j
j
j
j
j
j
j
j
j
j
j
j
j
j
j
q
q
q
k
k
k
k
"}
(4,1,1) = {"
k
k
k
q
q
j
j
F
O
F
O
F
j
I
j
j
j
j
F
O
F
O
F
j
j
q
q
k
k
k
"}
(5,1,1) = {"
k
k
q
q
j
j
j
F
x
w
O
F
j
j
j
j
j
j
F
C
w
O
F
j
j
j
q
q
k
k
"}
(6,1,1) = {"
k
k
q
j
j
j
j
F
M
w
O
F
j
j
j
D
j
j
F
x
w
R
F
j
I
j
j
q
k
k
"}
(7,1,1) = {"
k
q
q
j
j
j
j
F
O
F
O
F
j
y
j
j
j
j
F
O
F
O
F
j
j
j
c
q
q
k
"}
(8,1,1) = {"
k
q
c
j
j
j
j
j
j
j
j
j
j
j
j
j
j
j
j
j
j
j
j
j
j
j
c
c
q
k
"}
(9,1,1) = {"
k
q
c
c
c
j
j
j
j
j
j
j
j
j
j
j
j
j
j
j
j
j
j
j
j
c
c
c
q
k
"}
(10,1,1) = {"
k
q
c
c
c
c
c
c
c
c
c
c
j
j
j
j
j
j
c
c
c
c
c
c
c
c
c
c
q
k
"}
(11,1,1) = {"
k
q
j
j
c
c
c
c
c
c
c
c
c
A
c
c
c
c
c
c
c
c
c
c
c
c
c
q
q
k
"}
(12,1,1) = {"
k
q
j
j
j
c
c
c
c
c
G
c
c
c
c
G
c
c
c
c
G
c
c
c
c
c
q
V
q
k
"}
(13,1,1) = {"
k
q
z
j
j
c
c
c
c
c
c
c
c
c
c
c
c
c
c
c
c
c
c
c
c
q
U
i
q
k
"}
(14,1,1) = {"
k
q
j
j
j
j
c
t
t
t
O
t
t
t
t
O
t
t
t
t
P
t
t
t
t
q
i
i
n
k
"}
(15,1,1) = {"
k
q
a
j
j
j
t
i
i
i
i
i
i
i
i
i
i
i
i
i
i
i
i
i
i
Q
i
i
q
k
"}
(16,1,1) = {"
k
q
b
j
j
j
t
i
i
i
i
i
i
i
i
i
i
i
i
i
i
i
i
i
i
c
i
i
q
k
"}
(17,1,1) = {"
k
q
j
j
j
j
c
t
t
t
O
t
t
t
t
O
t
t
t
t
O
t
t
t
t
q
i
i
n
k
"}
(18,1,1) = {"
k
q
z
j
j
c
c
c
c
c
c
c
c
c
c
c
c
c
c
c
c
c
c
c
c
q
S
U
q
k
"}
(19,1,1) = {"
k
q
j
j
j
c
c
c
c
c
G
c
c
c
c
G
c
c
c
c
G
c
c
c
c
c
q
V
q
k
"}
(20,1,1) = {"
k
q
j
j
c
c
c
c
c
c
c
c
c
c
c
c
c
c
c
c
c
c
c
c
c
c
c
q
q
k
"}
(21,1,1) = {"
k
q
c
c
c
c
c
c
c
c
c
c
j
j
j
j
j
j
c
c
c
c
c
c
c
c
c
c
q
k
"}
(22,1,1) = {"
k
q
c
c
c
j
j
j
j
j
j
j
j
j
j
j
j
d
j
j
j
j
j
j
D
c
c
c
q
k
"}
(23,1,1) = {"
k
q
c
j
j
j
j
j
j
j
j
I
j
j
j
j
j
j
j
j
j
j
j
j
j
j
c
c
q
k
"}
(24,1,1) = {"
k
q
q
j
j
j
j
j
j
j
j
j
j
j
j
j
j
j
j
j
j
j
j
j
j
j
c
q
q
k
"}
(25,1,1) = {"
k
k
q
j
j
j
j
j
j
j
j
j
j
j
j
j
j
N
j
j
j
j
y
j
j
j
j
q
k
k
"}
(26,1,1) = {"
k
k
q
q
j
j
j
j
j
j
j
j
j
e
j
j
j
j
j
j
j
j
j
j
j
j
q
q
k
k
"}
(27,1,1) = {"
k
k
k
q
q
j
j
j
l
j
j
j
j
j
j
j
j
j
j
j
j
j
j
j
j
q
q
k
k
k
"}
(28,1,1) = {"
k
k
k
k
q
q
q
j
j
j
j
j
j
j
j
j
I
j
j
j
j
j
j
q
q
q
k
k
k
k
"}
(29,1,1) = {"
k
k
k
k
k
k
q
q
q
q
q
q
q
q
q
q
q
q
q
q
q
q
q
q
k
k
k
k
k
k
"}
(30,1,1) = {"
k
k
k
k
k
k
k
k
k
k
k
k
k
k
k
k
k
k
k
k
k
k
k
k
k
k
k
k
k
k
"}
