"a" = (/turf/closed/mineral/random/snow/no_caves,/area/snowplanet/surface/outdoors/ruin)
"b" = (/turf/closed/wall/mineral/wood/nonmetal,/area/ruin/powered)
"c" = (/obj/structure/closet/toolcloset,/obj/item/wrench,/obj/item/screwdriver,/obj/item/crowbar,/obj/item/weldingtool/largetank,/obj/item/wirecutters,/obj/item/radio/off,/turf/open/floor/wood,/area/ruin/powered)
"d" = (/turf/open/floor/plating/asteroid/snow/icemoon,/area/snowplanet/surface/outdoors/ruin)
"e" = (/obj/item/clothing/suit/hooded/explorer,/obj/item/clothing/mask/gas/explorer,/obj/item/clothing/gloves/color/black,/obj/item/storage/backpack/explorer,/obj/item/flashlight/lantern,/obj/item/storage/bag/ore,/obj/structure/closet,/obj/item/clothing/shoes/winterboots/ice_boots,/turf/open/floor/wood,/area/ruin/powered)
"f" = (/turf/open/floor/wood,/area/ruin/powered)
"g" = (/obj/structure/fireplace,/turf/open/floor/wood,/area/ruin/powered)
"h" = (/obj/structure/flora/rock/icy,/turf/closed/mineral/random/snow/no_caves,/area/snowplanet/surface/outdoors/ruin)
"i" = (/turf/template_noop,/area/template_noop)
"j" = (/obj/structure/sink/kitchen,/turf/open/floor/wood,/area/ruin/powered)
"k" = (/obj/structure/closet/crate/freezer,/turf/open/floor/wood,/area/ruin/powered)
"l" = (/obj/machinery/vending/dinnerware,/turf/open/floor/wood,/area/ruin/powered)
"m" = (/obj/structure/barricade/wooden/crude/snow,/turf/open/floor/wood,/area/ruin/powered)
"n" = (/obj/structure/mineral_door/wood,/turf/open/floor/wood,/area/ruin/powered)
"o" = (/obj/item/reagent_containers/food/drinks/beer,/turf/open/floor/wood,/area/ruin/powered)
"p" = (/obj/machinery/light/broken{dir = 4},/turf/open/floor/wood,/area/ruin/powered)
"q" = (/obj/structure/table/wood,/obj/item/pen,/obj/machinery/light/broken{dir = 8},/obj/item/paper/crumpled/bloody{info = "help..."; text = ""},/turf/open/floor/wood,/area/ruin/powered)
"r" = (/obj/item/chair/wood,/obj/effect/decal/cleanable/blood/splatter,/obj/effect/mob_spawn/human/miner/explorer,/obj/effect/decal/cleanable/blood/drip,/turf/open/floor/wood,/area/ruin/powered)
"s" = (/obj/effect/decal/cleanable/trail_holder,/turf/open/floor/wood,/area/ruin/powered)
"t" = (/turf/open/floor/plating/asteroid/snow/icemoon,/area/snowplanet/surface/outdoors/danger)

(1,1,1) = {"
iiiiiiiiiiiiiiiiiiiiiiiiiiiii
iiiiiiiitttttttttttiiiiiiiiii
iiiiitttttttttttttttttttiiiii
iiitttttttttttttttttttttttiii
iiittttttttttttttttttttttttii
iitttttttttttttttttttttttttti
iitttttttttttttttttttttttttti
iitttttdddddddddddddtttttttaa
ittttttddbbbbbbbbbbddtttttaaa
ittttttdbbbbbbbbbbbbddtttaaaa
ittttttdbbcefgfjklbbddddaaaaa
ittttttdbbfffffffffbbbbbhaaaa
ittttttdbbfffffffffffffmnhaaa
ittttttdbbofffffffpbbbbbhaaaa
ittttttdbbqrsssssfbbddddaaaaa
ittttttdbbbbbbbbbbbbdddddaaaa
iitttttddbbbbbbbbbbddtttddaaa
iittttttddddddddddddtttttddaa
iitttttttttttttttttttttttttti
iiittttttttttttttttttttttttti
iiiitttttttttttttttttttttttii
iiiiitttttttttttttttttttttiii
iiiiiiiittttttttttttttttiiiii
iiiiiiiiiittttttttttttiiiiiii
iiiiiiiiiiiiiiiiiiiiiiiiiiiii
"}
