//MAP CONVERTED BY dmm2tgm.py THIS HEADER COMMENT PREVENTS RECONVERSION, DO NOT REMOVE
"a" = (
/turf/template_noop,
/area/template_noop)
"b" = (
/turf/open/floor/plating/ice/icemoon,
/area/ruin/unpowered/icemoon/underground)
"c" = (
/obj/structure/flora/rock/icy,
/turf/open/floor/plating/ice/icemoon,
/area/ruin/unpowered/icemoon/underground)
"d" = (
/obj/item/flashlight/lantern{
	on = 1
	},
/turf/open/floor/plating/ice/icemoon,
/area/ruin/unpowered/icemoon/underground)
"e" = (
/obj/item/kitchen/knife/combat/survival,
/turf/open/floor/plating/ice/icemoon,
/area/ruin/unpowered/icemoon/underground)
"f" = (
/obj/item/clothing/suit/hooded/explorer,
/obj/effect/decal/cleanable/blood/gibs/up,
/turf/open/floor/plating/ice/icemoon,
/area/ruin/unpowered/icemoon/underground)
"g" = (
/obj/item/clothing/shoes/winterboots/ice_boots,
/turf/open/floor/plating/ice/icemoon,
/area/ruin/unpowered/icemoon/underground)
"h" = (
/mob/living/simple_animal/hostile/megafauna/irradiated_frost_miner,
/turf/open/floor/plating/ice/icemoon,
/area/ruin/unpowered/icemoon/underground)

(1,1,1) = {"
a
a
a
a
a
a
a
a
a
a
a
a
a
a
a
a
a
a
a
a
a
a
a
a
a
"}
(2,1,1) = {"
a
a
a
a
a
a
a
b
b
b
b
b
b
b
b
b
b
b
a
a
a
a
a
a
a
"}
(3,1,1) = {"
a
a
a
a
a
b
b
b
b
b
b
b
c
b
b
b
b
b
b
a
a
a
a
a
a
"}
(4,1,1) = {"
a
a
a
a
b
b
b
b
b
b
b
b
b
b
b
b
b
b
b
b
a
a
a
a
a
"}
(5,1,1) = {"
a
a
a
b
b
b
b
b
c
b
b
b
b
b
b
b
c
b
b
b
b
a
a
a
a
"}
(6,1,1) = {"
a
a
b
b
b
b
b
b
b
b
b
b
b
b
b
b
b
b
b
b
b
b
a
a
a
"}
(7,1,1) = {"
a
a
b
b
b
b
b
b
b
b
b
b
b
c
b
b
b
b
b
c
b
b
b
a
a
"}
(8,1,1) = {"
a
b
b
c
b
b
b
b
b
b
b
b
b
b
b
b
b
b
b
b
b
b
b
a
a
"}
(9,1,1) = {"
a
b
b
b
b
b
b
b
c
b
b
b
b
b
b
b
b
c
b
b
b
b
c
b
a
"}
(10,1,1) = {"
a
b
b
b
b
b
b
b
b
b
b
b
b
b
b
b
b
b
b
b
b
b
b
b
a
"}
(11,1,1) = {"
a
b
b
b
b
b
b
b
b
b
b
b
b
b
b
b
b
b
b
b
b
b
b
b
a
"}
(12,1,1) = {"
a
b
b
b
b
b
b
b
b
b
c
b
b
b
b
b
b
b
b
b
b
b
b
b
a
"}
(13,1,1) = {"
a
b
b
b
c
b
b
b
b
b
b
b
b
b
b
b
b
b
b
b
c
b
b
b
a
"}
(14,1,1) = {"
a
b
b
b
b
b
b
b
b
b
b
b
h
b
b
b
b
b
b
b
b
b
b
b
a
"}
(15,1,1) = {"
a
b
b
b
b
b
b
b
b
b
b
b
b
b
b
c
b
b
b
b
b
b
b
b
a
"}
(16,1,1) = {"
a
b
b
b
b
b
b
b
b
b
c
b
b
b
b
b
b
b
b
b
b
b
b
b
a
"}
(17,1,1) = {"
a
b
b
b
b
b
b
b
b
b
b
b
b
b
b
b
b
b
b
b
b
b
b
b
a
"}
(18,1,1) = {"
a
b
c
b
b
b
b
c
b
b
b
b
b
b
b
b
b
b
b
b
c
b
b
b
a
"}
(19,1,1) = {"
a
b
b
b
b
b
b
b
b
b
b
b
b
b
b
b
b
b
b
b
b
b
b
b
a
"}
(20,1,1) = {"
a
b
b
b
b
b
b
b
b
b
b
b
b
b
c
b
b
b
b
b
b
b
b
b
a
"}
(21,1,1) = {"
a
b
b
b
b
b
b
b
b
b
b
b
b
b
b
b
b
b
b
b
b
b
b
b
a
"}
(22,1,1) = {"
a
b
b
b
b
b
b
b
b
b
c
b
b
b
b
b
b
b
b
b
b
b
b
b
a
"}
(23,1,1) = {"
a
b
b
b
c
b
b
b
b
b
b
b
b
b
b
b
b
b
c
b
b
b
b
a
a
"}
(24,1,1) = {"
a
a
b
b
b
b
d
e
b
b
b
b
b
b
b
b
b
b
b
b
b
b
a
a
a
"}
(25,1,1) = {"
a
a
a
b
b
b
b
f
b
b
b
b
b
b
b
b
b
b
b
b
b
a
a
a
a
"}
(26,1,1) = {"
a
a
a
a
b
b
b
g
b
c
b
b
b
b
c
b
b
b
b
b
a
a
a
a
a
"}
(27,1,1) = {"
a
a
a
a
a
b
b
b
b
b
b
b
b
b
b
b
b
b
b
a
a
a
a
a
a
"}
(28,1,1) = {"
a
a
a
a
a
a
a
b
b
b
b
b
b
b
b
b
b
b
a
a
a
a
a
a
a
"}
(29,1,1) = {"
a
a
a
a
a
a
a
a
a
a
a
a
a
a
a
a
a
a
a
a
a
a
a
a
a
"}
