"a" = (/turf/open/floor/plating/asteroid/snow/icemoon,/area/snowplanet/surface/outdoors/danger)
"b" = (/turf/closed/wall/mineral/snow,/area/snowplanet/surface/outdoors/ruin)
"c" = (/obj/structure/bed/dogbed,/turf/open/floor/plating/asteroid/snow/icemoon,/area/snowplanet/surface/outdoors/ruin)
"d" = (/turf/open/floor/plating/asteroid/snow/icemoon,/area/snowplanet/surface/outdoors/ruin)
"e" = (/obj/item/clothing/suit/armor/vest/russian,/turf/open/floor/plating/asteroid/snow/icemoon,/area/snowplanet/surface/outdoors/ruin)
"f" = (/obj/effect/mob_spawn/human/corpse/russian,/turf/open/floor/plating/asteroid/snow/icemoon,/area/snowplanet/surface/outdoors/ruin)
"g" = (/mob/living/simple_animal/hostile/bear/russian,/turf/open/floor/plating/asteroid/snow/icemoon,/area/snowplanet/surface/outdoors/ruin)
"h" = (/obj/item/clothing/suit/armor/navyblue/russian,/turf/open/floor/plating/asteroid/snow/icemoon,/area/snowplanet/surface/outdoors/ruin)
"i" = (/obj/item/kitchen/knife/combat/survival,/turf/open/floor/plating/asteroid/snow/icemoon,/area/snowplanet/surface/outdoors/ruin)
"j" = (/obj/item/reagent_containers/food/drinks/bottle/vodka/badminka,/turf/open/floor/plating/asteroid/snow/icemoon,/area/snowplanet/surface/outdoors/ruin)
"k" = (/obj/structure/bonfire,/turf/open/floor/plating/asteroid/snow/icemoon,/area/snowplanet/surface/outdoors/ruin)
"l" = (/obj/item/reagent_containers/food/drinks/bottle/vodka,/turf/open/floor/plating/asteroid/snow/icemoon,/area/snowplanet/surface/outdoors/ruin)
"m" = (/mob/living/simple_animal/hostile/russian,/turf/open/floor/plating/asteroid/snow/icemoon,/area/snowplanet/surface/outdoors/ruin)

(1,1,1) = {"
aaabbbbaaa
aabbbbbbaa
aabbcdbbaa
abbefgdbba
abbhijdbba
bbbddkldba
bbbmdddbba
abbdddbbaa
aadddddaaa
aaaaaaaaaa
"}
