"a" = (/turf/template_noop,/area/ruin/snowplanet/underground/powered)
"b" = (/turf/open/floor/plating/asteroid/snow/icemoon,/area/ruin/snowplanet/underground/powered)
"c" = (/obj/effect/sliding_puzzle/lavaland,/turf/open/floor/plating/asteroid/snow/icemoon,/area/ruin/snowplanet/underground/powered)

(1,1,1) = {"
aaaaa
abbba
abcba
abbba
aaaaa
"}
