"a" = (/turf/open/floor/plating/asteroid/snow/atmosphere,/area/snowplanet/surface/outdoors/ruin)
"b" = (/turf/closed/indestructible/wood,/area/ruin/unpowered)
"c" = (/obj/structure/window/spawner,/obj/machinery/shower{dir = 4},/turf/open/floor/plasteel/showroomfloor,/area/ruin/unpowered)
"d" = (/obj/structure/fluff/snowlegion,/turf/open/floor/plasteel/showroomfloor,/area/ruin/unpowered)
"e" = (/obj/structure/bookcase/random/fiction,/turf/open/floor/wood/cold,/area/ruin/unpowered)
"f" = (/obj/structure/bookcase/random/nonfiction,/turf/open/floor/wood/cold,/area/ruin/unpowered)
"g" = (/obj/structure/bookcase/random/reference,/turf/open/floor/wood/cold,/area/ruin/unpowered)
"h" = (/obj/structure/bookcase/random/religion,/turf/open/floor/wood/cold,/area/ruin/unpowered)
"i" = (/obj/structure/bookcase/random/adult,/turf/open/floor/wood/cold,/area/ruin/unpowered)
"j" = (/obj/structure/toilet{dir = 4},/turf/open/floor/wood/cold,/area/ruin/unpowered)
"k" = (/turf/open/floor/wood/cold,/area/ruin/unpowered)
"l" = (/obj/structure/bed,/obj/item/bedsheet/cosmos,/turf/open/floor/wood/cold,/area/ruin/unpowered)
"m" = (/obj/effect/spawner/structure/window/ice,/turf/open/floor/wood/cold,/area/ruin/unpowered)
"n" = (/obj/structure/curtain,/turf/open/floor/wood/cold,/area/ruin/unpowered)
"o" = (/turf/open/floor/carpet/royalblue,/area/ruin/unpowered)
"p" = (/obj/structure/chair/wood,/turf/open/floor/carpet/royalblue,/area/ruin/unpowered)
"q" = (/obj/structure/statue/snow/snowman,/turf/open/floor/carpet/royalblue,/area/ruin/unpowered)
"r" = (/obj/structure/table/wood/fancy/blackred,/turf/open/floor/carpet/royalblue,/area/ruin/unpowered)
"s" = (/obj/structure/chair/wood{icon_state = "wooden_chair"; dir = 8},/turf/open/floor/carpet/royalblue,/area/ruin/unpowered)
"t" = (/obj/structure/statue/snow/snowman,/turf/open/floor/wood/cold,/area/ruin/unpowered)
"u" = (/obj/structure/chair/wood{icon_state = "wooden_chair"; dir = 4},/turf/open/floor/carpet/royalblue,/area/ruin/unpowered)
"v" = (/obj/structure/chair/wood{icon_state = "wooden_chair"; dir = 1},/turf/open/floor/carpet/royalblue,/area/ruin/unpowered)
"w" = (/obj/structure/fermenting_barrel,/turf/open/floor/wood/cold,/area/ruin/unpowered)
"x" = (/obj/machinery/jukebox,/turf/open/floor/wood/cold,/area/ruin/unpowered)
"y" = (/obj/structure/sign/warning,/turf/closed/indestructible/wood,/area/ruin/unpowered)
"z" = (/obj/structure/mineral_door/wood,/obj/structure/barricade/wooden/snowed,/turf/open/floor/wood/cold,/area/ruin/unpowered)
"A" = (/obj/machinery/grill,/turf/open/floor/plating/asteroid/snow/atmosphere,/area/snowplanet/surface/outdoors/ruin)

(1,1,1) = {"
aaaaaaaaaaaaaaa
aaaaaaaaaaaaaaa
aabbbbbbbbbbaaa
aabcdbefghibaaa
aabjkbkkkklmaaa
aabbnbkkkkkbaaa
aabkkkopoqkbaaa
aabkkkorrskbaaa
aamkkturrokmaaa
aabkkkoovokbaaa
aabwkkkkkkxbaaa
aabbmmbyzybbaaa
aaaaaaAaaaaaaaa
aaaaaaaaaaaaaaa
aaaaaaaaaaaaaaa
"}
