//MAP CONVERTED BY dmm2tgm.py THIS HEADER COMMENT PREVENTS RECONVERSION, DO NOT REMOVE
"a" = (
/turf/open/floor/plating/asteroid/snow/icemoon,
/area/ruin/powered)
"b" = (
/turf/closed/wall/mineral/silver,
/area/ruin/unpowered/icemoon/underground)
"c" = (
/obj/structure/table,
/obj/machinery/dish_drive,
/obj/machinery/light{
	dir = 1;
	light_color = "#cee5d2"
	},
/turf/open/floor/plasteel/cafeteria,
/area/ruin/unpowered/icemoon/underground)
"d" = (
/obj/machinery/grill,
/turf/open/floor/plasteel/cafeteria,
/area/ruin/unpowered/icemoon/underground)
"e" = (
/obj/structure/table,
/obj/machinery/reagentgrinder,
/turf/open/floor/plasteel/cafeteria,
/area/ruin/unpowered/icemoon/underground)
"f" = (
/obj/structure/table,
/obj/item/flashlight/lamp/bananalamp,
/turf/open/floor/plasteel/cafeteria,
/area/ruin/unpowered/icemoon/underground)
"g" = (
/obj/structure/table,
/obj/structure/showcase/machinery/microwave,
/turf/open/floor/plasteel/cafeteria,
/area/ruin/unpowered/icemoon/underground)
"h" = (
/obj/structure/sink/kitchen,
/turf/open/floor/plasteel/cafeteria,
/area/ruin/unpowered/icemoon/underground)
"i" = (
/obj/structure/table,
/obj/item/reagent_containers/food/snacks/burger/roburgerbig,
/turf/open/floor/plasteel/cafeteria,
/area/ruin/unpowered/icemoon/underground)
"j" = (
/obj/structure/table,
/obj/item/reagent_containers/food/snacks/burger/xeno,
/turf/open/floor/plasteel/cafeteria,
/area/ruin/unpowered/icemoon/underground)
"k" = (
/obj/structure/closet/secure_closet/freezer/meat/open,
/turf/open/floor/plasteel/cafeteria,
/area/ruin/unpowered/icemoon/underground)
"l" = (
/obj/structure/closet/secure_closet/freezer/gulag_fridge,
/turf/open/floor/plasteel/cafeteria,
/area/ruin/unpowered/icemoon/underground)
"m" = (
/obj/structure/closet/secure_closet/freezer/cream_pie,
/obj/machinery/light{
	dir = 1;
	light_color = "#cee5d2"
	},
/turf/open/floor/plasteel/cafeteria,
/area/ruin/unpowered/icemoon/underground)
"n" = (
/turf/open/floor/plasteel/cafeteria,
/area/ruin/unpowered/icemoon/underground)
"o" = (
/mob/living/simple_animal/hostile/bear/Hudson{
	desc = "Welcome to flavortown!";
	faction = list("neutral");
	name = "Guy Fieri"
	},
/turf/open/floor/plasteel/cafeteria,
/area/ruin/unpowered/icemoon/underground)
"p" = (
/obj/structure/table/reinforced,
/obj/item/kitchen/knife/butcher,
/turf/open/floor/plasteel/cafeteria,
/area/ruin/unpowered/icemoon/underground)
"q" = (
/obj/structure/table/reinforced,
/obj/item/kitchen/rollingpin,
/turf/open/floor/plasteel/cafeteria,
/area/ruin/unpowered/icemoon/underground)
"r" = (
/obj/structure/table/reinforced,
/obj/item/kitchen/fork,
/turf/open/floor/plasteel/cafeteria,
/area/ruin/unpowered/icemoon/underground)
"s" = (
/obj/structure/table/reinforced,
/obj/item/kitchen/knife/carrotshiv,
/turf/open/floor/plasteel/cafeteria,
/area/ruin/unpowered/icemoon/underground)
"t" = (
/obj/structure/table/reinforced,
/obj/item/reagent_containers/food/snacks/burger/rib,
/turf/open/floor/plasteel/cafeteria,
/area/ruin/unpowered/icemoon/underground)
"u" = (
/obj/structure/table/reinforced,
/turf/open/floor/plasteel/cafeteria,
/area/ruin/unpowered/icemoon/underground)
"v" = (
/obj/machinery/gibber,
/turf/open/floor/plasteel/cafeteria,
/area/ruin/unpowered/icemoon/underground)
"w" = (
/obj/machinery/icecream_vat,
/turf/open/floor/plasteel/cafeteria,
/area/ruin/unpowered/icemoon/underground)
"x" = (
/obj/structure/table/reinforced,
/obj/item/kitchen/knife/scimitar,
/turf/open/floor/plasteel/cafeteria,
/area/ruin/unpowered/icemoon/underground)
"y" = (
/obj/structure/table/reinforced,
/obj/item/reagent_containers/food/snacks/cakebatter,
/turf/open/floor/plasteel/cafeteria,
/area/ruin/unpowered/icemoon/underground)
"z" = (
/obj/structure/table/reinforced,
/obj/item/reagent_containers/food/snacks/carpmeat,
/turf/open/floor/plasteel/cafeteria,
/area/ruin/unpowered/icemoon/underground)
"A" = (
/obj/machinery/processor,
/turf/open/floor/plasteel/cafeteria,
/area/ruin/unpowered/icemoon/underground)
"B" = (
/obj/structure/table/reinforced,
/obj/item/reagent_containers/food/snacks/carrotfries,
/turf/open/floor/plasteel/cafeteria,
/area/ruin/unpowered/icemoon/underground)
"C" = (
/obj/structure/table/reinforced,
/obj/item/reagent_containers/food/snacks/carneburrito,
/obj/item/reagent_containers/food/snacks/carneburrito,
/obj/item/reagent_containers/food/snacks/carneburrito,
/turf/open/floor/plasteel/cafeteria,
/area/ruin/unpowered/icemoon/underground)
"D" = (
/obj/structure/table/reinforced,
/obj/item/reagent_containers/food/snacks/butterdog,
/turf/open/floor/plasteel/cafeteria,
/area/ruin/unpowered/icemoon/underground)
"E" = (
/obj/structure/table/reinforced,
/obj/item/reagent_containers/food/snacks/candy_corn,
/obj/item/reagent_containers/food/snacks/candy_corn,
/obj/item/reagent_containers/food/snacks/candy_corn,
/obj/item/reagent_containers/food/snacks/candy_corn,
/turf/open/floor/plasteel/cafeteria,
/area/ruin/unpowered/icemoon/underground)
"F" = (
/obj/structure/table/reinforced,
/obj/item/reagent_containers/food/snacks/candiedapple,
/turf/open/floor/plasteel/cafeteria,
/area/ruin/unpowered/icemoon/underground)
"G" = (
/obj/structure/table/reinforced,
/obj/item/ammo_box/magazine/m45/kitchengun,
/turf/open/floor/plasteel/cafeteria,
/area/ruin/unpowered/icemoon/underground)
"H" = (
/obj/machinery/processor/slime,
/turf/open/floor/plasteel/cafeteria,
/area/ruin/unpowered/icemoon/underground)
"I" = (
/obj/machinery/light,
/turf/open/floor/plasteel/cafeteria,
/area/ruin/unpowered/icemoon/underground)
"J" = (
/obj/machinery/light_switch,
/turf/closed/wall/mineral/silver,
/area/ruin/unpowered/icemoon/underground)
"K" = (
/obj/machinery/door/airlock/freezer,
/turf/open/floor/plating/asteroid/snow/icemoon,
/area/ruin/unpowered/icemoon/underground)

(1,1,1) = {"
a
a
a
a
a
a
a
a
a
a
"}
(2,1,1) = {"
a
b
b
b
b
b
b
b
b
a
"}
(3,1,1) = {"
a
b
c
n
n
w
n
I
b
a
"}
(4,1,1) = {"
a
b
d
n
n
n
n
n
b
a
"}
(5,1,1) = {"
a
b
e
n
p
x
B
n
b
a
"}
(6,1,1) = {"
a
b
f
n
q
y
y
n
b
a
"}
(7,1,1) = {"
a
b
g
o
p
y
C
n
b
a
"}
(8,1,1) = {"
a
b
h
n
r
u
D
I
b
a
"}
(9,1,1) = {"
a
b
i
n
s
u
E
n
b
a
"}
(10,1,1) = {"
a
b
j
n
t
u
F
n
b
a
"}
(11,1,1) = {"
a
b
k
n
u
z
G
n
J
a
"}
(12,1,1) = {"
a
b
l
n
n
n
n
n
K
a
"}
(13,1,1) = {"
a
b
m
n
v
A
H
I
b
a
"}
(14,1,1) = {"
a
b
b
b
b
b
b
b
b
a
"}
(15,1,1) = {"
a
a
a
a
a
a
a
a
a
a
"}
