"a" = (/turf/open/floor/plating/asteroid/snow/icemoon,/area/snowplanet/surface/outdoors/ruin)
"b" = (/turf/closed/wall/mineral/titanium/survival/pod,/area/ruin/snowplanet/surface/powered)
"c" = (/obj/structure/fans,/turf/open/floor/pod/dark,/area/ruin/snowplanet/surface/powered)
"d" = (/obj/machinery/smartfridge/survival_pod,/turf/open/floor/pod/dark,/area/ruin/snowplanet/surface/powered)
"e" = (/obj/item/gps/computer{gpstag = "Distress Signal"},/turf/open/floor/pod/dark,/area/ruin/snowplanet/surface/powered)
"f" = (/obj/structure/ore_box,/turf/open/floor/pod/dark,/area/ruin/snowplanet/surface/powered)
"g" = (/obj/structure/table/reinforced,/obj/effect/spawner/lootdrop/mre,/turf/open/floor/pod/dark,/area/ruin/snowplanet/surface/powered)
"h" = (/obj/structure/table/reinforced,/obj/effect/spawner/lootdrop/glowstick,/turf/open/floor/pod/dark,/area/ruin/snowplanet/surface/powered)
"i" = (/obj/machinery/sleeper/survival_pod,/turf/open/floor/pod/dark,/area/ruin/snowplanet/surface/powered)
"j" = (/obj/effect/decal/cleanable/dirt,/obj/effect/decal/cleanable/blood/old,/turf/open/floor/pod/dark,/area/ruin/snowplanet/surface/powered)
"k" = (/obj/structure/tubes,/obj/machinery/light/small{dir = 4},/turf/open/floor/pod/dark,/area/ruin/snowplanet/surface/powered)
"l" = (/turf/open/floor/pod/dark,/area/ruin/snowplanet/surface/powered)
"m" = (/obj/effect/decal/cleanable/dirt,/turf/open/floor/pod/dark,/area/ruin/snowplanet/surface/powered)
"n" = (/obj/machinery/vending/sustenance,/turf/open/floor/pod/dark,/area/ruin/snowplanet/surface/powered)
"o" = (/obj/effect/decal/cleanable/dirt,/obj/effect/decal/cleanable/blood/old{icon_state = "trails_1"; name = "dried blood trail"},/turf/open/floor/pod/dark,/area/ruin/snowplanet/surface/powered)
"p" = (/obj/machinery/vending/wallmed,/turf/closed/wall/mineral/titanium/survival/pod,/area/ruin/snowplanet/surface/powered)
"q" = (/obj/effect/spawner/lootdrop/crate_spawner,/turf/open/floor/pod/dark,/area/ruin/snowplanet/surface/powered)
"r" = (/obj/structure/bed/pod{name = "bed"},/obj/item/bedsheet/black,/turf/open/floor/pod/dark,/area/ruin/snowplanet/surface/powered)
"s" = (/obj/structure/fluff/empty_cryostasis_sleeper,/obj/machinery/light/small{dir = 8},/turf/open/floor/pod/dark,/area/ruin/snowplanet/surface/powered)
"t" = (/obj/effect/decal/cleanable/dirt,/obj/effect/decal/cleanable/blood/old{dir = 10; icon_state = "trails_1"; name = "dried blood trail"},/turf/open/floor/pod/dark,/area/ruin/snowplanet/surface/powered)
"u" = (/obj/effect/decal/cleanable/dirt,/obj/effect/decal/cleanable/generic,/obj/effect/decal/cleanable/blood/old{dir = 8; icon_state = "trails_1"; name = "dried blood trail"},/turf/open/floor/pod/dark,/area/ruin/snowplanet/surface/powered)
"v" = (/obj/effect/decal/cleanable/dirt,/obj/effect/decal/cleanable/blood/old{dir = 8; icon_state = "trails_1"; name = "dried blood trail"},/turf/open/floor/pod/dark,/area/ruin/snowplanet/surface/powered)
"w" = (/obj/effect/mob_spawn/human/miner/explorer,/obj/effect/decal/cleanable/dirt,/obj/effect/decal/cleanable/blood/old,/turf/open/floor/pod/dark,/area/ruin/snowplanet/surface/powered)
"x" = (/obj/effect/decal/cleanable/dirt,/obj/effect/decal/cleanable/dirt,/turf/open/floor/pod/dark,/area/ruin/snowplanet/surface/powered)
"y" = (/obj/structure/table/reinforced,/obj/machinery/light{dir = 4},/turf/open/floor/pod/dark,/area/ruin/snowplanet/surface/powered)
"z" = (/obj/structure/fluff/empty_cryostasis_sleeper,/turf/open/floor/pod/dark,/area/ruin/snowplanet/surface/powered)
"A" = (/obj/machinery/door/airlock/survival_pod/glass,/obj/structure/fans/tiny,/obj/structure/barricade/wooden/crude/snow,/turf/open/floor/pod/dark,/area/ruin/snowplanet/surface/powered)
"B" = (/mob/living/simple_animal/hostile/skeleton/plasmaminer,/turf/open/floor/plating/asteroid/snow/icemoon,/area/snowplanet/surface/outdoors/ruin)
"C" = (/obj/effect/decal/cleanable/blood/old{dir = 8; icon_state = "trails_1"; name = "dried blood trail"},/turf/open/floor/plating/asteroid/snow/icemoon,/area/snowplanet/surface/outdoors/ruin)
"D" = (/obj/effect/decal/cleanable/blood/old,/obj/effect/decal/cleanable/blood/old{dir = 8; icon_state = "trails_1"; name = "dried blood trail"},/turf/open/floor/plating/asteroid/snow/icemoon,/area/snowplanet/surface/outdoors/ruin)
"E" = (/obj/effect/decal/cleanable/blood/old{name = "dried blood splatter"; pixel_x = -29},/turf/open/floor/plating/asteroid/snow/icemoon,/area/snowplanet/surface/outdoors/ruin)
"F" = (/turf/open/lava/plasma/ice_moon,/area/snowplanet/surface/outdoors/ruin)
"J" = (/turf/template_noop,/area/template_noop)

(1,1,1) = {"
JJJJaaaaaJJJJJJ
JbbbbbbbbbbJJJJ
JbcdebffghbJJJJ
JbijkbllmnbaJJJ
JbbopbqmmrbaJJJ
JbstuvvwxybaaJJ
abzmmmlmmrbaaaJ
abbbAbbbbbbaaaJ
aaaaaBaCCCCDaaJ
aaaaaaaaaaaEaaa
JaaaaFFFFFFFaaa
JaaFFFFFFFFFFFa
JJaFFFFFFFFFFFa
JJaaFFFFFFFaaaa
JJaaaaaaaaaaaJJ
"}
