"aa" = (/obj/structure/sign/poster/official/work_for_a_future,/turf/closed/wall/mineral/wood,/area/ruin/unpowered)
"ab" = (/obj/structure/showcase/machinery/tv,/obj/effect/decal/cleanable/dirt,/obj/machinery/light/broken{dir = 1},/turf/open/floor/holofloor/wood,/area/ruin/unpowered)
"ac" = (/obj/machinery/vending/snack/random,/turf/open/floor/holofloor/wood,/area/ruin/unpowered)
"ad" = (/obj/machinery/washing_machine,/obj/effect/decal/cleanable/blood,/obj/item/reagent_containers/food/snacks/meat/slab/corgi,/turf/open/floor/wood,/area/ruin/unpowered)
"ae" = (/turf/closed/mineral/random/snow/no_caves,/area/snowplanet/underground/outdoors/ruin)
"af" = (/turf/open/floor/plating/asteroid/snow/icemoon,/area/snowplanet/underground/outdoors/ruin)
"ag" = (/obj/structure/table/wood,/obj/structure/bedsheetbin,/turf/open/floor/wood,/area/ruin/unpowered)
"ah" = (/obj/structure/table/wood,/obj/item/clothing/shoes/sneakers/white,/turf/open/floor/wood,/area/ruin/unpowered)
"ai" = (/obj/structure/chair/sofa/right{dir = 1},/turf/open/floor/wood,/area/ruin/unpowered)
"aj" = (/obj/structure/chair/sofa/left{dir = 1},/obj/effect/decal/cleanable/dirt,/turf/open/floor/wood,/area/ruin/unpowered)
"ak" = (/obj/structure/flora/rock/pile/icy,/turf/open/floor/plating/asteroid/snow/icemoon,/area/snowplanet/underground/outdoors/ruin)
"al" = (/obj/structure/flora/stump,/turf/open/floor/plating/asteroid/snow/icemoon,/area/snowplanet/underground/outdoors/ruin)
"am" = (/obj/structure/flora/rock/icy,/turf/open/floor/plating/asteroid/snow/icemoon,/area/snowplanet/underground/outdoors/ruin)
"an" = (/obj/structure/flora/grass/green,/turf/open/floor/plating/asteroid/snow/icemoon,/area/snowplanet/underground/outdoors/ruin)
"ao" = (/turf/closed/wall/rust,/area/ruin/unpowered)
"ap" = (/turf/open/floor/plating/asteroid/snow/ice/icemoon,/area/snowplanet/underground/outdoors/ruin)
"aq" = (/turf/closed/mineral/snowmountain/cavern/icemoon,/area/snowplanet/underground/outdoors/ruin)
"ar" = (/turf/open/floor/plating/ice/icemoon,/area/snowplanet/underground/outdoors/ruin)
"as" = (/obj/structure/flora/ausbushes/sparsegrass,/turf/open/floor/plating/asteroid/snow/icemoon,/area/snowplanet/underground/outdoors/ruin)
"at" = (/obj/structure/flora/grass/both,/turf/open/floor/plating/asteroid/snow/icemoon,/area/snowplanet/underground/outdoors/ruin)
"au" = (/turf/closed/wall/mineral/wood,/area/ruin/unpowered)
"av" = (/obj/effect/decal/cleanable/blood/gibs/up,/obj/effect/mob_spawn/human/corpse/assistant,/mob/living/simple_animal/hostile/skeleton/eskimo{name = "Village Hunter"},/turf/open/floor/plating/asteroid/snow/icemoon,/area/snowplanet/underground/outdoors/ruin)
"aw" = (/obj/effect/decal/cleanable/blood/gibs/torso,/obj/effect/decal/remains/human,/mob/living/simple_animal/hostile/construct/armored/hostile{health = 450; maxHealth = 450; name = "Left Hand of the Elder"},/turf/open/floor/engine/cult,/area/ruin/unpowered)
"ax" = (/obj/item/kitchen/knife/rainbowknife{force = 18},/turf/open/floor/engine/cult,/area/ruin/unpowered)
"ay" = (/obj/structure/closet/emcloset,/obj/item/tank/internals/emergency_oxygen,/obj/item/tank/internals/emergency_oxygen,/obj/item/clothing/mask/breath/medical,/obj/item/clothing/mask/breath/medical,/obj/item/flashlight/lantern,/turf/open/floor/plasteel/freezer,/area/ruin/unpowered)
"az" = (/obj/effect/decal/remains/human,/mob/living/simple_animal/hostile/construct/armored/hostile{health = 450; maxHealth = 450; name = "Right Hand of the Elder"},/turf/open/floor/engine/cult,/area/ruin/unpowered)
"aA" = (/obj/effect/decal/cleanable/blood/tracks{dir = 4},/obj/effect/decal/cleanable/blood/footprints{dir = 8},/turf/open/floor/plating/asteroid/snow/icemoon,/area/snowplanet/underground/outdoors/ruin)
"aB" = (/obj/effect/decal/cleanable/blood/splatter,/obj/effect/decal/cleanable/blood/footprints{dir = 8},/turf/open/floor/plating/asteroid/snow/icemoon,/area/snowplanet/underground/outdoors/ruin)
"aC" = (/obj/structure/chair/sofa/left,/turf/closed/mineral/snowmountain/cavern/icemoon,/area/snowplanet/underground/outdoors/ruin)
"aD" = (/obj/effect/decal/cleanable/dirt,/obj/structure/rack,/obj/item/storage/bag/ore,/obj/item/storage/toolbox/mechanical,/turf/open/floor/plasteel/freezer,/area/ruin/unpowered)
"aE" = (/obj/effect/decal/cleanable/blood/tracks,/obj/effect/decal/cleanable/blood/footprints{dir = 1},/turf/open/floor/plating/asteroid/snow/icemoon,/area/snowplanet/underground/outdoors/ruin)
"aF" = (/obj/effect/decal/cleanable/blood/gibs/limb,/turf/open/floor/engine/cult,/area/ruin/unpowered)
"aG" = (/obj/effect/decal/cleanable/blood/splatter,/mob/living/simple_animal/hostile/illusion{deathmessage = "disperses into the air in a cloud of red mist, you feel slightly more at ease."; desc = "You can't quite make out what you're seeing."; faction = list("cult"); health = 500; maxHealth = 500; melee_damage_lower = 10; melee_damage_upper = 30; name = "Village Elder"},/turf/open/floor/engine/cult,/area/ruin/unpowered)
"aH" = (/obj/effect/decal/cleanable/blood/gibs/down,/obj/item/pickaxe,/turf/open/floor/engine/cult,/area/ruin/unpowered)
"aI" = (/obj/structure/flora/tree/pine,/turf/open/floor/plating/asteroid/snow/icemoon,/area/snowplanet/underground/outdoors/ruin)
"aJ" = (/obj/structure/mirror{broken = 1},/turf/closed/wall/mineral/wood,/area/ruin/unpowered)
"aK" = (/turf/open/floor/plasteel/freezer,/area/ruin/unpowered)
"aL" = (/obj/machinery/light/small/broken{dir = 4},/obj/structure/fluff/fokoff_sign,/turf/open/floor/plating/asteroid/snow/icemoon,/area/snowplanet/underground/outdoors/ruin)
"aM" = (/obj/structure/sign/poster/ripped,/turf/closed/wall/rust,/area/snowplanet/underground/outdoors/ruin)
"aN" = (/obj/structure/mirror,/turf/closed/wall/mineral/wood,/area/ruin/unpowered)
"aO" = (/obj/machinery/door/airlock/wood,/obj/effect/mapping_helpers/airlock/locked,/obj/structure/barricade/wooden/crude,/turf/open/floor/wood,/area/ruin/unpowered)
"aP" = (/turf/closed/wall,/area/snowplanet/underground/outdoors/ruin)
"aQ" = (/obj/effect/decal/cleanable/blood/footprints{dir = 1},/obj/item/restraints/legcuffs/beartrap{armed = 1},/obj/structure/flora/grass/both,/turf/open/floor/plating/asteroid/snow/icemoon,/area/snowplanet/underground/outdoors/ruin)
"aR" = (/turf/closed/wall,/area/ruin/unpowered)
"aS" = (/obj/structure/table,/obj/item/reagent_containers/food/snacks/fishandchips,/turf/open/floor/plasteel/checker,/area/ruin/unpowered)
"aT" = (/obj/structure/closet/secure_closet/freezer,/obj/item/reagent_containers/food/snacks/carpmeat,/obj/item/reagent_containers/food/snacks/carpmeat,/obj/item/reagent_containers/food/snacks/carpmeat,/obj/item/reagent_containers/food/condiment/pack/ketchup,/obj/item/reagent_containers/food/condiment/pack/ketchup,/obj/item/reagent_containers/food/condiment/pack/ketchup,/turf/open/floor/plasteel/checker,/area/ruin/unpowered)
"aU" = (/obj/structure/dresser,/obj/effect/decal/cleanable/glass,/turf/open/floor/wood,/area/ruin/unpowered)
"aV" = (/obj/structure/closet/cabinet,/obj/item/clothing/under/rank/miner,/obj/item/clothing/suit/hooded/wintercoat/miner,/obj/item/clothing/shoes/winterboots,/obj/item/card/id/mining,/obj/effect/decal/cleanable/dirt,/turf/open/floor/wood,/area/ruin/unpowered)
"aW" = (/obj/effect/decal/cleanable/dirt,/turf/open/floor/plasteel/freezer,/area/ruin/unpowered)
"aX" = (/turf/closed/mineral/snowmountain/icemoon,/area/snowplanet/underground/outdoors/ruin)
"aY" = (/obj/structure/dresser,/turf/open/floor/wood,/area/ruin/unpowered)
"aZ" = (/obj/effect/decal/cleanable/dirt,/turf/open/floor/wood,/area/ruin/unpowered)
"ba" = (/turf/open/floor/carpet,/area/ruin/unpowered)
"bb" = (/obj/structure/fireplace{fuel_added = 1000; lit = 1},/obj/effect/decal/cleanable/dirt,/turf/open/floor/carpet,/area/ruin/unpowered)
"bc" = (/obj/machinery/door/airlock/maintenance_hatch,/turf/open/floor/plating,/area/ruin/unpowered)
"bd" = (/obj/machinery/door/airlock/wood,/obj/effect/decal/cleanable/dirt,/turf/open/floor/wood,/area/ruin/unpowered)
"be" = (/obj/structure/bed/dogbed{pixel_y = 14},/obj/effect/decal/cleanable/dirt,/turf/open/floor/carpet,/area/ruin/unpowered)
"bf" = (/obj/structure/closet/crate/trashcart,/obj/effect/decal/cleanable/dirt,/obj/effect/decal/cleanable/blood,/obj/item/bodypart/head,/obj/item/bodypart/l_arm{pixel_x = -9; pixel_y = -9},/obj/item/bodypart/l_leg,/obj/item/bodypart/r_arm,/obj/item/bodypart/r_leg{pixel_x = 8; pixel_y = 4},/obj/item/bodypart/chest,/obj/item/organ/heart,/obj/item/multitool,/turf/open/floor/plasteel/freezer,/area/ruin/unpowered)
"bg" = (/obj/effect/decal/cleanable/blood/drip,/obj/structure/fence/door,/turf/open/floor/plating/asteroid/snow/icemoon,/area/snowplanet/underground/outdoors/ruin)
"bh" = (/obj/structure/sink/kitchen{dir = 4; pixel_x = -12},/obj/effect/decal/cleanable/dirt,/turf/open/floor/plasteel/checker,/area/ruin/unpowered)
"bi" = (/obj/item/flashlight/lantern{on = 1},/obj/effect/decal/cleanable/dirt,/turf/open/floor/wood,/area/ruin/unpowered)
"bj" = (/obj/structure/closet/crate/trashcart,/obj/effect/decal/cleanable/dirt,/obj/item/trash/chips,/obj/item/trash/semki{pixel_x = 8; pixel_y = -4},/obj/item/clothing/neck/petcollar,/turf/open/floor/plasteel/freezer,/area/ruin/unpowered)
"bk" = (/obj/effect/decal/cleanable/blood/drip,/turf/open/floor/wood,/area/ruin/unpowered)
"bl" = (/obj/structure/bed,/obj/effect/decal/cleanable/blood,/obj/item/bedsheet/random,/turf/open/floor/wood,/area/ruin/unpowered)
"bm" = (/obj/structure/flora/ausbushes/fullgrass,/obj/structure/flora/grass/both,/obj/structure/fence{dir = 8},/turf/open/floor/plating/asteroid/snow/icemoon,/area/snowplanet/underground/outdoors/ruin)
"bn" = (/obj/structure/flora/rock/icy,/obj/effect/mob_spawn/human/corpse/assistant,/turf/open/floor/plating/asteroid/snow/icemoon,/area/snowplanet/underground/outdoors/ruin)
"bo" = (/obj/effect/decal/cleanable/blood/splatter,/turf/open/floor/plating/snowed/smoothed/icemoon,/area/snowplanet/underground/outdoors/ruin)
"bp" = (/obj/structure/bed,/obj/item/bedsheet/random,/turf/open/floor/wood,/area/ruin/unpowered)
"bq" = (/obj/effect/decal/cleanable/blood,/turf/open/floor/wood,/area/ruin/unpowered)
"br" = (/obj/effect/decal/cleanable/dirt,/obj/machinery/door/airlock/wood,/turf/open/floor/plating,/area/ruin/unpowered)
"bs" = (/obj/structure/closet/cabinet,/obj/item/restraints/legcuffs/beartrap,/obj/item/restraints/legcuffs/beartrap,/obj/item/reagent_containers/glass/bottle/venom,/obj/item/reagent_containers/glass/bottle/curare,/obj/item/kitchen/knife/combat/survival,/obj/effect/decal/cleanable/dirt,/obj/item/reagent_containers/food/snacks/meat/slab/human,/obj/item/reagent_containers/food/snacks/meat/slab/human,/obj/item/reagent_containers/food/snacks/meat/slab/human,/turf/open/floor/wood,/area/ruin/unpowered)
"bt" = (/obj/item/clothing/head/bearpelt,/obj/structure/table/wood,/obj/item/reagent_containers/food/snacks/burger/fish,/obj/item/reagent_containers/food/drinks/beer{pixel_x = -4},/obj/item/reagent_containers/food/drinks/beer{pixel_x = 10; pixel_y = 6},/turf/open/floor/wood,/area/ruin/unpowered)
"bu" = (/obj/effect/decal/cleanable/vomit,/obj/structure/toilet{dir = 1},/turf/open/floor/plating,/area/ruin/unpowered)
"bv" = (/turf/open/floor/plating/snowed/smoothed/icemoon,/area/snowplanet/underground/outdoors/ruin)
"bw" = (/obj/structure/flora/bush,/turf/open/floor/plating/asteroid/snow/icemoon,/area/snowplanet/underground/outdoors/ruin)
"bx" = (/obj/structure/fence,/turf/open/floor/plating/asteroid/snow/icemoon,/area/snowplanet/underground/outdoors/ruin)
"by" = (/obj/effect/decal/cleanable/blood/drip,/turf/open/floor/plating/asteroid/snow/icemoon,/area/snowplanet/underground/outdoors/ruin)
"bz" = (/obj/structure/flora/ausbushes/fullgrass,/turf/open/floor/plating/asteroid/snow/icemoon,/area/snowplanet/underground/outdoors/ruin)
"bA" = (/obj/machinery/light/small{dir = 4},/turf/open/floor/plating/asteroid/snow/icemoon,/area/snowplanet/underground/outdoors/ruin)
"bB" = (/obj/structure/sign/poster/official/nanotrasen_logo,/turf/closed/wall,/area/snowplanet/underground/outdoors/ruin)
"bC" = (/obj/structure/fence/door/opened{dir = 8},/turf/open/floor/plating/snowed/smoothed/icemoon,/area/snowplanet/underground/outdoors/ruin)
"bD" = (/obj/structure/flora/ausbushes/fullgrass,/obj/structure/flora/grass/both,/turf/open/floor/plating/asteroid/snow/icemoon,/area/snowplanet/underground/outdoors/ruin)
"bE" = (/obj/structure/flora/grass/brown,/turf/open/floor/plating/asteroid/snow/icemoon,/area/snowplanet/underground/outdoors/ruin)
"bF" = (/obj/item/reagent_containers/food/drinks/beer,/turf/open/floor/plating/ice/icemoon,/area/snowplanet/underground/outdoors/ruin)
"bG" = (/obj/structure/chair/wood{dir = 4},/turf/open/floor/plating/ice/icemoon,/area/snowplanet/underground/outdoors/ruin)
"bH" = (/obj/structure/fence{dir = 8},/turf/open/floor/plating/asteroid/snow/icemoon,/area/snowplanet/underground/outdoors/ruin)
"bI" = (/obj/structure/fence/cut/medium{dir = 4},/turf/open/floor/plating/asteroid/snow/icemoon,/area/snowplanet/underground/outdoors/ruin)
"bJ" = (/obj/structure/flora/grass/both,/obj/effect/decal/remains/human,/turf/open/floor/plating/asteroid/snow/icemoon,/area/snowplanet/underground/outdoors/ruin)
"bS" = (/obj/effect/decal/cleanable/dirt,/obj/structure/bed,/obj/item/bedsheet/cult,/turf/open/floor/wood,/area/ruin/unpowered)
"bT" = (/turf/open/floor/wood,/area/ruin/unpowered)
"bU" = (/obj/structure/chair/comfy/brown{dir = 4},/turf/open/floor/carpet,/area/ruin/unpowered)
"bV" = (/obj/structure/table/wood,/obj/item/reagent_containers/food/snacks/sashimi{pixel_y = 10},/obj/item/reagent_containers/food/drinks/mug/coco{pixel_x = -10},/obj/item/reagent_containers/food/drinks/mug/coco{pixel_x = 10; pixel_y = -4},/obj/effect/decal/cleanable/dirt,/turf/open/floor/carpet,/area/ruin/unpowered)
"bW" = (/obj/structure/chair/comfy/brown{dir = 8},/turf/open/floor/carpet,/area/ruin/unpowered)
"ca" = (/obj/machinery/door/airlock/wood,/turf/open/floor/wood,/area/ruin/unpowered)
"cb" = (/obj/effect/decal/cleanable/dirt,/obj/structure/closet/cabinet,/obj/item/clothing/suit/hooded/wintercoat,/obj/item/clothing/shoes/winterboots,/obj/item/clothing/under/gimmick/rank/captain/suit,/turf/open/floor/wood,/area/ruin/unpowered)
"cf" = (/obj/machinery/door/airlock/wood,/obj/structure/barricade/wooden/crude/snow,/turf/open/floor/wood,/area/ruin/unpowered)

(1,1,1) = {"
aeaeaeaeaeaeaeafafaeaeaeaeaeaeaeaeaeaeaeaeaeaeaeaeaeaeae
aeaeaeaeaeakafafafafafafafafafafafafafafafalaeaeaeaeaeae
aeaeaeaeafafamafafanapapapaqaqaqaqaqaqaqafafakaeaeaeaeae
aeaearapafafafafaqaqaqaqaqaqauauauauauaqasafafapararaeae
aeapapafafalaqaqaqaqaqaqaqaqauawaxazauaqaqaqafafapapaeae
aeafafafataqaqaqavaAaAaAaBaqauaFaGaHauaCaqaqaqafapamaeae
afafafaqaqaqauauauaJauauaEaIauaNaOauauauauaqaqafafafafaf
afaLaMaPaqaqauaSaTaUaVauaQasauaYaZbabbbeauaqaqaqaqakafaf
afafakaXaqakaubhbibkblaubgbmaubSbTbUbVbWauaIaqaqaqaqafae
afafaXbnbobvauauaucaauauafafaucbbTaZbTaZauafbwaqaqaqafae
afafafaqakbvafafbxbvbyafbyafauauaucfauauauafbzaqaqaqafae
afbAbBaPaqbvbvbvbCbvbvbvbvafafafafbvafbDafafapaqaqaqafae
amafafaqaqaqaIauauauauafbvafbvbvbvbvafafbEapapaqaqaqafae
aeafafaqauauaaauabacauaIbvafbvbzafafafapaparararaqaqakae
aeafafaqauadaZaZbTbTcabvbvbvbvafafafapararbFararaqaqamae
aeatafaqauauagahaiajaubzafafbvafafafbEaparbGararaqaqafae
aeafafaqaqauauauauauaubwafafbvafaIafafapararararaqaqafae
aeafafaqaqaRaoaRaRaRafbvbvbvbvafafbDafafaparararaqaqafae
aeafakaqaqaRayayaDaoafbvafafbvafafafafafasaparaqaqaqafae
aeafafaqaqaoaKaWaKbcbvbvauaubdauafafafafafapaqaqaqapafaf
aeafafbzaqaobfbjaoaRbHbIaubpbqaubrauafafafafaqaqaqafalaf
aeafafapaqaRaRaoaoafaIafaubsbtaubuauafafbwaqaqaqafafbzae
aeafafapaqaqaqbJafbzafafauauauauauauaIafaqaqaqakafafapae
aeaeafafapaqaqaqaqaqaqaqaqaqaqaqaqaqaqaqaqaqafamafapaeae
aeaealafafafamaqaqaqaqaqaqaqaqaqaqaqaqaqaqalafafafaeaeae
aeaeaeapafatafafafafafaqaqaqalafafafafafafafafafafafakaf
aeaeaeaeafafafafafafafafakafafafafafbEafafafafafafafafaf
aeaeaeaeafafaeaeaeaeafafafafapaeaeaeaeaeaeaeaeaeaeaeaeae
"}
