"a" = (/turf/open/floor/plating/asteroid/snow/icemoon,/area/snowplanet/surface/outdoors/danger)
"b" = (/turf/closed/wall/mineral/silver,/area/ruin/snowplanet/surface)
"c" = (/obj/structure/table,/obj/machinery/dish_drive,/obj/machinery/light{dir = 1; light_color = "#cee5d2"},/turf/open/floor/plasteel/cafeteria,/area/ruin/snowplanet/surface)
"d" = (/obj/machinery/grill,/turf/open/floor/plasteel/cafeteria,/area/ruin/snowplanet/surface)
"e" = (/obj/structure/table,/obj/machinery/reagentgrinder,/turf/open/floor/plasteel/cafeteria,/area/ruin/snowplanet/surface)
"f" = (/obj/structure/table,/obj/item/flashlight/lamp/bananalamp,/turf/open/floor/plasteel/cafeteria,/area/ruin/snowplanet/surface)
"g" = (/obj/structure/table,/obj/structure/showcase/machinery/microwave,/turf/open/floor/plasteel/cafeteria,/area/ruin/snowplanet/surface)
"h" = (/obj/structure/sink/kitchen,/turf/open/floor/plasteel/cafeteria,/area/ruin/snowplanet/surface)
"i" = (/obj/structure/table,/obj/item/reagent_containers/food/snacks/burger/roburgerbig,/turf/open/floor/plasteel/cafeteria,/area/ruin/snowplanet/surface)
"j" = (/obj/structure/table,/obj/item/reagent_containers/food/snacks/burger/xeno,/turf/open/floor/plasteel/cafeteria,/area/ruin/snowplanet/surface)
"k" = (/obj/structure/closet/secure_closet/freezer/meat/open,/turf/open/floor/plasteel/cafeteria,/area/ruin/snowplanet/surface)
"l" = (/obj/structure/closet/secure_closet/freezer/gulag_fridge,/turf/open/floor/plasteel/cafeteria,/area/ruin/snowplanet/surface)
"m" = (/obj/structure/closet/secure_closet/freezer/cream_pie,/obj/machinery/light{dir = 1; light_color = "#cee5d2"},/turf/open/floor/plasteel/cafeteria,/area/ruin/snowplanet/surface)
"n" = (/turf/open/floor/plasteel/cafeteria,/area/ruin/snowplanet/surface)
"o" = (/mob/living/simple_animal/hostile/bear/Hudson{desc = "Welcome to flavortown!"; faction = list("neutral"); name = "Guy Fieri"},/turf/open/floor/plasteel/cafeteria,/area/ruin/snowplanet/surface)
"p" = (/obj/structure/table/reinforced,/obj/item/kitchen/knife/butcher,/turf/open/floor/plasteel/cafeteria,/area/ruin/snowplanet/surface)
"q" = (/obj/structure/table/reinforced,/obj/item/kitchen/rollingpin,/turf/open/floor/plasteel/cafeteria,/area/ruin/snowplanet/surface)
"r" = (/obj/structure/table/reinforced,/obj/item/kitchen/fork,/turf/open/floor/plasteel/cafeteria,/area/ruin/snowplanet/surface)
"s" = (/obj/structure/table/reinforced,/obj/item/kitchen/knife/carrotshiv,/turf/open/floor/plasteel/cafeteria,/area/ruin/snowplanet/surface)
"t" = (/obj/structure/table/reinforced,/obj/item/reagent_containers/food/snacks/burger/rib,/turf/open/floor/plasteel/cafeteria,/area/ruin/snowplanet/surface)
"u" = (/obj/structure/table/reinforced,/turf/open/floor/plasteel/cafeteria,/area/ruin/snowplanet/surface)
"v" = (/obj/machinery/gibber,/turf/open/floor/plasteel/cafeteria,/area/ruin/snowplanet/surface)
"w" = (/obj/machinery/icecream_vat,/turf/open/floor/plasteel/cafeteria,/area/ruin/snowplanet/surface)
"x" = (/obj/structure/table/reinforced,/obj/item/kitchen/knife/scimitar,/turf/open/floor/plasteel/cafeteria,/area/ruin/snowplanet/surface)
"y" = (/obj/structure/table/reinforced,/obj/item/reagent_containers/food/snacks/cakebatter,/turf/open/floor/plasteel/cafeteria,/area/ruin/snowplanet/surface)
"z" = (/obj/structure/table/reinforced,/obj/item/reagent_containers/food/snacks/carpmeat,/turf/open/floor/plasteel/cafeteria,/area/ruin/snowplanet/surface)
"A" = (/obj/machinery/processor,/turf/open/floor/plasteel/cafeteria,/area/ruin/snowplanet/surface)
"B" = (/obj/structure/table/reinforced,/obj/item/reagent_containers/food/snacks/carrotfries,/turf/open/floor/plasteel/cafeteria,/area/ruin/snowplanet/surface)
"C" = (/obj/structure/table/reinforced,/obj/item/reagent_containers/food/snacks/carneburrito,/obj/item/reagent_containers/food/snacks/carneburrito,/obj/item/reagent_containers/food/snacks/carneburrito,/turf/open/floor/plasteel/cafeteria,/area/ruin/snowplanet/surface)
"D" = (/obj/structure/table/reinforced,/obj/item/reagent_containers/food/snacks/butterdog,/turf/open/floor/plasteel/cafeteria,/area/ruin/snowplanet/surface)
"E" = (/obj/structure/table/reinforced,/obj/item/reagent_containers/food/snacks/candy_corn,/obj/item/reagent_containers/food/snacks/candy_corn,/obj/item/reagent_containers/food/snacks/candy_corn,/obj/item/reagent_containers/food/snacks/candy_corn,/turf/open/floor/plasteel/cafeteria,/area/ruin/snowplanet/surface)
"F" = (/obj/structure/table/reinforced,/obj/item/reagent_containers/food/snacks/candiedapple,/turf/open/floor/plasteel/cafeteria,/area/ruin/snowplanet/surface)
"G" = (/obj/structure/table/reinforced,/obj/item/ammo_box/magazine/m45/kitchengun,/turf/open/floor/plasteel/cafeteria,/area/ruin/snowplanet/surface)
"H" = (/obj/machinery/processor/slime,/turf/open/floor/plasteel/cafeteria,/area/ruin/snowplanet/surface)
"I" = (/obj/machinery/light,/turf/open/floor/plasteel/cafeteria,/area/ruin/snowplanet/surface)
"J" = (/obj/machinery/light_switch,/turf/closed/wall/mineral/silver,/area/ruin/snowplanet/surface)
"K" = (/obj/machinery/door/airlock/freezer,/turf/open/floor/plating/asteroid/snow/icemoon,/area/ruin/snowplanet/surface)
"L" = (/turf/open/floor/plating/asteroid/snow/icemoon,/area/snowplanet/surface/outdoors/ruin)

(1,1,1) = {"
aaaaaaaaaaaaaaa
abbbbbbbbbbbbba
abcdefghijklmba
abnnnnonnnnnnba
abnnpqprstunvba
abwnxyyuuuznAba
abnnByCDEFGnHba
abInnnnInnnnIba
abbbbbbbbbJKbba
aaaaaaaaaLLLLaa
"}
