"a" = (/turf/closed/mineral/random/snow/no_caves,/area/snowplanet/surface/outdoors/danger)
"b" = (/turf/open/floor/plating/asteroid/snow/icemoon,/area/snowplanet/surface/outdoors/danger)
"c" = (/turf/open/floor/plating/asteroid/snow/icemoon,/area/snowplanet/surface/outdoors/ruin)
"d" = (/turf/open/water,/area/snowplanet/surface/outdoors/ruin)
"e" = (/obj/item/paper/crumpled{info = "When one falls into this hot spring, they shall forever be turned into..."},/turf/open/floor/plating/asteroid/snow/icemoon,/area/snowplanet/surface/outdoors/ruin)

(1,1,1) = {"
aaaaaaaaaaa
aaabbbbbaaa
aabcccccbaa
abccdddccba
abcdddddcba
abcdddddeba
abcdddddcba
abccdddccba
aabcccccbaa
aaabbbbbaaa
aaaaaaaaaaa
"}
