//MAP CONVERTED BY dmm2tgm.py THIS HEADER COMMENT PREVENTS RECONVERSION, DO NOT REMOVE
"a" = (
/turf/closed/mineral/random/snow/no_caves,
/area/ruin/unpowered/icemoon/underground)
"b" = (
/turf/open/floor/plating/asteroid/snow/icemoon,
/area/ruin/unpowered/icemoon/underground)
"c" = (
/obj/structure/spawner/nether,
/turf/open/floor/plating/asteroid/snow/icemoon,
/area/ruin/unpowered/icemoon/underground)

(1,1,1) = {"
a
a
a
a
a
a
a
a
a
a
a
a
a
a
a
"}
(2,1,1) = {"
a
a
a
a
a
a
a
a
a
a
a
a
a
a
a
"}
(3,1,1) = {"
a
a
a
a
a
b
b
b
b
b
a
a
a
a
a
"}
(4,1,1) = {"
a
a
a
b
b
b
b
b
b
b
b
b
a
a
a
"}
(5,1,1) = {"
a
a
a
b
b
b
b
b
b
b
b
b
a
a
a
"}
(6,1,1) = {"
a
a
b
b
b
b
b
b
b
b
b
b
b
a
a
"}
(7,1,1) = {"
a
a
b
b
b
b
b
b
b
b
b
b
b
a
a
"}
(8,1,1) = {"
a
a
b
b
b
b
b
c
b
b
b
b
b
a
a
"}
(9,1,1) = {"
a
a
b
b
b
b
b
b
b
b
b
b
b
a
a
"}
(10,1,1) = {"
a
a
b
b
b
b
b
b
b
b
b
b
b
a
a
"}
(11,1,1) = {"
a
a
a
b
b
b
b
b
b
b
b
b
a
a
a
"}
(12,1,1) = {"
a
a
a
b
b
b
b
b
b
b
b
b
a
a
a
"}
(13,1,1) = {"
a
a
a
a
a
b
b
b
b
b
a
a
a
a
a
"}
(14,1,1) = {"
a
a
a
a
a
a
a
a
a
a
a
a
a
a
a
"}
(15,1,1) = {"
a
a
a
a
a
a
a
a
a
a
a
a
a
a
a
"}
